S.N.,Candidate,Party,EVM Votes,Postal Votes,Total Votes,percentage  of Votes,Assembly Constituency,Assembly Constituency Number ,State 
1,ALURI CHINNARAO,Bahujan Samaj Party,1536,7,1543,1.02,Achanta,56,Andhra Pradesh 
2,CHERUKUVADA SRI RANGANADHA RAJU,Yuvajana Sramika Rythu Congress Party,58353,495,58848,39.09,Achanta,56,Andhra Pradesh 
3,NEKKANTI VENKATA SATYANARAYANA (SATISH),Indian National Congress,1859,13,1872,1.24,Achanta,56,Andhra Pradesh 
4,SATYANARAYANA PITHANI,Telugu Desam,84429,973,85402,56.73,Achanta,56,Andhra Pradesh 
5,ALLADA SURYA BHASKARA RAO,Jaathia Chethi Vruthula Ikya Vedika Party,275,0,275,0.18,Achanta,56,Andhra Pradesh 
6,KAKI SYAM KUMAR,Jaibhim Rao Bharat Party,215,0,215,0.14,Achanta,56,Andhra Pradesh 
7,VELAGALA SREENIVASA REDDY,Jai Bharat National Party,267,3,270,0.18,Achanta,56,Andhra Pradesh 
8,RAMOJU PURNA CHANDRA SEKHAR,Independent,150,0,150,0.1,Achanta,56,Andhra Pradesh 
9,SIKILE RATNARAJU,Independent,293,0,293,0.19,Achanta,56,Andhra Pradesh 
10,NOTA,None of the Above,1661,12,1673,1.11,Achanta,56,Andhra Pradesh 
11,KISHORE BABU ADUSUMALLI,Indian National Congress,4055,17,4072,1.89,Addanki ,105,Andhra Pradesh 
12,GOTTIPATI RAVI KUMAR,Telugu Desam,115078,1340,116418,54.02,Addanki ,105,Andhra Pradesh 
13,CHINNA HANIMIREDDY PANEM,Yuvajana Sramika Rythu Congress Party,90696,832,91528,42.47,Addanki ,105,Andhra Pradesh 
14,JOSEPH MANDA,Bahujan Samaj Party,438,10,448,0.21,Addanki ,105,Andhra Pradesh 
15,KANDULA YAKOBU,Liberation Congress Party,81,2,83,0.04,Addanki ,105,Andhra Pradesh 
16,GUNTUPALLI GOPI,Navodayam Party,49,0,49,0.02,Addanki ,105,Andhra Pradesh 
17,GUMMA SADASIVARAO,Pyramid Party of India,51,0,51,0.02,Addanki ,105,Andhra Pradesh 
18,PULIPATI HEBELU,Jaibhim Rao Bharat Party,109,5,114,0.05,Addanki ,105,Andhra Pradesh 
19,MEESALA SAMRAJYAM,Bharatha Chaitanya Yuvajana Party,107,3,110,0.05,Addanki ,105,Andhra Pradesh 
20,RAMBABU BACHINA,Jateeya Sama Samajam Party,448,0,448,0.21,Addanki ,105,Andhra Pradesh 
21,ATLA CHINA VENKATA REDDY,Independent,39,0,39,0.02,Addanki ,105,Andhra Pradesh 
22,DUPATI YESOBU,Independent,55,1,56,0.03,Addanki ,105,Andhra Pradesh 
23,PRABHUDASU SURABHI,Independent,69,0,69,0.03,Addanki ,105,Andhra Pradesh 
24,MANDA SRINIVASA RAO,Independent,245,6,251,0.12,Addanki ,105,Andhra Pradesh 
25,VENKATA CHARI GOLLAPATI,Independent,182,0,182,0.08,Addanki ,105,Andhra Pradesh 
26,NOTA,None of the Above,1591,9,1600,0.74,Addanki ,105,Andhra Pradesh 
27,ASIYA BANU AMLIVALE,Bahujan Samaj Party,2143,9,2152,1.22,Adoni ,146,Andhra Pradesh 
28,DR. PARTHA SARATHI VALMIKI,Bharatiya Janata Party,88943,986,89929,51.06,Adoni ,146,Andhra Pradesh 
29,G. RAMESH YADAV,Indian National Congress,7567,55,7622,4.33,Adoni ,146,Andhra Pradesh 
30,Y. SAI PRASAD REDDY,Yuvajana Sramika Rythu Congress Party,71297,468,71765,40.74,Adoni ,146,Andhra Pradesh 
31,K. RANGANNA,Jaibhim Rao Bharat Party,468,3,471,0.27,Adoni ,146,Andhra Pradesh 
32,URUKUNDU VADDE,Independent,139,1,140,0.08,Adoni ,146,Andhra Pradesh 
33,G JAYANNA,Independent,273,1,274,0.16,Adoni ,146,Andhra Pradesh 
34,K. DASTAGIRI NAIDU,Independent,726,1,727,0.41,Adoni ,146,Andhra Pradesh 
35,B. NAGARAJ,Independent,267,1,268,0.15,Adoni ,146,Andhra Pradesh 
36,G. YUVARAJ,Independent,1162,8,1170,0.66,Adoni ,146,Andhra Pradesh 
37,NOTA,None of the Above,1597,18,1615,0.92,Adoni ,146,Andhra Pradesh 
38,AKHILA PRIYA BHUMA,Telugu Desam,97473,1408,98881,49.93,Allagadda ,134,Andhra Pradesh 
39,BARAGODLA HUSSAIN BASHA,Indian National Congress,6057,43,6100,3.08,Allagadda ,134,Andhra Pradesh 
40,BRIJENDRA REDDY GANGULA (NANI),Yuvajana Sramika Rythu Congress Party,85966,878,86844,43.85,Allagadda ,134,Andhra Pradesh 
41,VARIKUTI HANNAMMA,Bahujan Samaj Party,1025,5,1030,0.52,Allagadda ,134,Andhra Pradesh 
42,EPANAGANDLA SREENIVASULU YADAV,Samajwadi Party,162,2,164,0.08,Allagadda ,134,Andhra Pradesh 
43,M.KRISHNA REDDY,Praja Ektha Party,129,1,130,0.07,Allagadda ,134,Andhra Pradesh 
44,CHEEMALA RAMESH,Navarang Congress Party,113,0,113,0.06,Allagadda ,134,Andhra Pradesh 
45,CHENNAIAH MADARA,Anna YSR Congress Party,105,3,108,0.05,Allagadda ,134,Andhra Pradesh 
46,DARA SHEKHAR,Jaibhim Rao Bharat Party,117,2,119,0.06,Allagadda ,134,Andhra Pradesh 
47,NERELLA OBULESU,Revolutionary Socialist Party,216,2,218,0.11,Allagadda ,134,Andhra Pradesh 
48,C. VENKATA RAMANA,Neethi Nijayithi Party,91,2,93,0.05,Allagadda ,134,Andhra Pradesh 
49,ANISETTY BALA PEDDAIAH,Independent,110,1,111,0.06,Allagadda ,134,Andhra Pradesh 
50,ARLA PADMAJA,Independent,114,1,115,0.06,Allagadda ,134,Andhra Pradesh 
51,KOTTAPU PEDDI REDDY,Independent,272,0,272,0.14,Allagadda ,134,Andhra Pradesh 
52,GANGULA PRAHLADA REDDY,Independent,321,1,322,0.16,Allagadda ,134,Andhra Pradesh 
53,K. CHANDRA SEKHARA REDDY,Independent,657,0,657,0.33,Allagadda ,134,Andhra Pradesh 
54,JAJJARI MARIYADAS,Independent,855,1,856,0.43,Allagadda ,134,Andhra Pradesh 
55,T.A. NARASIMHA RAO,Independent,337,0,337,0.17,Allagadda ,134,Andhra Pradesh 
56,NOTA,None of the Above,1564,18,1582,0.8,Allagadda ,134,Andhra Pradesh 
57,ARAKATLA NAVEEN KISHOR,Indian National Congress,5751,21,5772,2.74,Alur,147,Andhra Pradesh 
58,H. RAMALINGAIAH,Bahujan Samaj Party,1364,5,1369,0.65,Alur,147,Andhra Pradesh 
59,B. VIRUPAKSHI,Yuvajana Sramika Rythu Congress Party,99785,479,100264,47.65,Alur,147,Andhra Pradesh 
60,B. VEERABHADRA GOWD,Telugu Desam,96597,836,97433,46.3,Alur,147,Andhra Pradesh 
61,N MOHAN PRASAD,Bharatha Chaitanya Yuvajana Party,673,1,674,0.32,Alur,147,Andhra Pradesh 
62,SHAIK. SHAIKSHA VALI,Jai Bharat National Party,275,1,276,0.13,Alur,147,Andhra Pradesh 
63,M. AMANULLA,Independent,227,0,227,0.11,Alur,147,Andhra Pradesh 
64,ADONI ANJANEYULU,Independent,200,0,200,0.1,Alur,147,Andhra Pradesh 
65,RANGASWAMY KAVALI,Independent,220,0,220,0.1,Alur,147,Andhra Pradesh 
66,R. LOKANATH,Independent,282,0,282,0.13,Alur,147,Andhra Pradesh 
67,B. SATYANNA,Independent,534,2,536,0.25,Alur,147,Andhra Pradesh 
68,HEBBATAM VANNURAPPA,Independent,542,0,542,0.26,Alur,147,Andhra Pradesh 
69,NOTA,None of the Above,2629,5,2634,1.25,Alur,147,Andhra Pradesh 
70,ANNAJIRAO SANAPALA,Indian National Congress,3456,25,3481,2.19,Amadalavalasa ,6,Andhra Pradesh 
71,KOONA RAVI KUMAR,Telugu Desam,85121,2882,88003,55.45,Amadalavalasa ,6,Andhra Pradesh 
72,THAMMINENI SEETARAM,Yuvajana Sramika Rythu Congress Party,51938,1033,52971,33.38,Amadalavalasa ,6,Andhra Pradesh 
73,SOMESWARA RAO LASA,Bahujan Samaj Party,355,4,359,0.23,Amadalavalasa ,6,Andhra Pradesh 
74,GURUGU REVATHI,Jaathia Chethi Vruthula Ikya Vedika Party,183,4,187,0.12,Amadalavalasa ,6,Andhra Pradesh 
75,BURIDI GOURI SHANKAR,Jai Bharat National Party,110,3,113,0.07,Amadalavalasa ,6,Andhra Pradesh 
76,MUDDADA MADHUSUDANA RAO,Pyramid Party of India,85,0,85,0.05,Amadalavalasa ,6,Andhra Pradesh 
77,SEPENA SRINIVASA RAO,Bharatha Chaitanya Yuvajana Party,99,0,99,0.06,Amadalavalasa ,6,Andhra Pradesh 
78,GANAPATHI JAGADEESWARA RAO (JAGADEESH),Independent,535,11,546,0.34,Amadalavalasa ,6,Andhra Pradesh 
79,GANDHI SUVVARI,Independent,9188,349,9537,6.01,Amadalavalasa ,6,Andhra Pradesh 
80,MUDDADA RAMBUJJI,Independent,166,0,166,0.1,Amadalavalasa ,6,Andhra Pradesh 
81,LOLUGU VENKATA RAJASEKHAR,Independent,451,23,474,0.3,Amadalavalasa ,6,Andhra Pradesh 
82,SANAPALA SURESH KUMAR,Independent,383,3,386,0.24,Amadalavalasa ,6,Andhra Pradesh 
83,NOTA,None of the Above,2282,18,2300,1.45,Amadalavalasa ,6,Andhra Pradesh 
84,AITHABATHULA ANANDARAO,Telugu Desam,102426,1596,104022,58.56,Amalapuram ,44,Andhra Pradesh 
85,AITHABATHULA SUBHASHINI,Indian National Congress,1327,30,1357,0.76,Amalapuram ,44,Andhra Pradesh 
86,MOHAN BABU POLAMURI,Bahujan Samaj Party,1971,20,1991,1.12,Amalapuram ,44,Andhra Pradesh 
87,VISWARUPU PINIPE,Yuvajana Sramika Rythu Congress Party,64594,800,65394,36.81,Amalapuram ,44,Andhra Pradesh 
88,AITABATHULA ABHIMANYUDU,Jatiya Jana Sena Party,278,1,279,0.16,Amalapuram ,44,Andhra Pradesh 
89,AITABATTULA ANANDA BABU,Navarang Congress Party,125,0,125,0.07,Amalapuram ,44,Andhra Pradesh 
90,ISWARYA BOJJA,Liberation Congress Party,95,3,98,0.06,Amalapuram ,44,Andhra Pradesh 
91,JANGA RAJENDRAKUMAR,Loktantrik Janta Dal,784,11,795,0.45,Amalapuram ,44,Andhra Pradesh 
92,DEVARAPALLI RAJIV,Jai Bharat National Party,90,0,90,0.05,Amalapuram ,44,Andhra Pradesh 
93,CHUTTUGULLA VEERA VENKATA SATYANARAYANA,Independent,309,6,315,0.18,Amalapuram ,44,Andhra Pradesh 
94,PARAMATA SYAMKUMAR,Independent,768,25,793,0.45,Amalapuram ,44,Andhra Pradesh 
95,BEERA RAMARAO,Independent,100,0,100,0.06,Amalapuram ,44,Andhra Pradesh 
96,VARASALA SATYANARAYANA,Independent,143,1,144,0.08,Amalapuram ,44,Andhra Pradesh 
97,NOTA,None of the Above,2105,28,2133,1.2,Amalapuram ,44,Andhra Pradesh 
98,I. R. GANGADHAR,Indian National Congress,1841,54,1895,1.1,Anakapalle ,30,Andhra Pradesh 
99,BHARATH KUMAR MALASALA,Yuvajana Sramika Rythu Congress Party,48652,710,49362,28.57,Anakapalle ,30,Andhra Pradesh 
100,SUDHIKONDA MANIKYALA RAO,Bahujan Samaj Party,1297,9,1306,0.76,Anakapalle ,30,Andhra Pradesh 
101,OMMI VENKAT YADAV,Samajwadi Party,381,4,385,0.22,Anakapalle ,30,Andhra Pradesh 
102,AMBIKADEVI POLAMARASETTY,Pyramid Party of India,238,7,245,0.14,Anakapalle ,30,Andhra Pradesh 
103,KANISETTY SURESH BABU,Jai Bharat National Party,692,8,700,0.41,Anakapalle ,30,Andhra Pradesh 
104,KONATHALA RAMAKRISHNA,Janasena Party,113185,1941,115126,66.63,Anakapalle ,30,Andhra Pradesh 
105,THOTA VENKATA SAI MUKUND,Praja Prasthanam Party,227,2,229,0.13,Anakapalle ,30,Andhra Pradesh 
106,DOMMESI APPARAO,Republican Party of India (Khobragade),274,1,275,0.16,Anakapalle ,30,Andhra Pradesh 
107,V.V. RAMACHANDRA RAO SURISETTY,Prem Janata Dal,435,1,436,0.25,Anakapalle ,30,Andhra Pradesh 
108,ALLA SATTI RAJU,Independent,313,1,314,0.18,Anakapalle ,30,Andhra Pradesh 
109,KAPARAPU SATYANARAYANA,Independent,652,0,652,0.38,Anakapalle ,30,Andhra Pradesh 
110,NOTA,None of the Above,1827,26,1853,1.07,Anakapalle ,30,Andhra Pradesh 
111,ANANTHA VENKATARAMI REDDY,Yuvajana Sramika Rythu Congress Party,78273,2038,80311,42.36,Anantapur Urban,153,Andhra Pradesh 
112,DAGGUPATI PRASAD,Telugu Desam,99062,4272,103334,54.51,Anantapur Urban,153,Andhra Pradesh 
113,K. NAGARAJU,Bahujan Samaj Party,458,18,476,0.25,Anantapur Urban,153,Andhra Pradesh 
114,AKULA RAGHAVENDRA,Jai Bharat National Party,302,7,309,0.16,Anantapur Urban,153,Andhra Pradesh 
115,KUMMETHA SURYA SEKHARA REDDY,All India Forward Bloc,113,3,116,0.06,Anantapur Urban,153,Andhra Pradesh 
116,C. JAFFER,Communist Party of India,2706,132,2838,1.5,Anantapur Urban,153,Andhra Pradesh 
117,BHASKAR TALARI,All India Kisan Janatha party,81,1,82,0.04,Anantapur Urban,153,Andhra Pradesh 
118,D. RAGHAVENDRA,Socialist Unity Centre Of India (COMMUNIST),109,3,112,0.06,Anantapur Urban,153,Andhra Pradesh 
119,GADIYARAM MALLIKARJUNA SARMA,Independent,108,4,112,0.06,Anantapur Urban,153,Andhra Pradesh 
120,CHIGICHERLA MALLIKARJUNA,Independent,64,1,65,0.03,Anantapur Urban,153,Andhra Pradesh 
121,JAYALAKSHMI,Independent,86,2,88,0.05,Anantapur Urban,153,Andhra Pradesh 
122,SREERANGARAJULA GOPINATH ROYAL,Independent,93,1,94,0.05,Anantapur Urban,153,Andhra Pradesh 
123,V. SAI PRASAD,Independent,97,2,99,0.05,Anantapur Urban,153,Andhra Pradesh 
124,V. SURENDRA RAO,Independent,49,1,50,0.03,Anantapur Urban,153,Andhra Pradesh 
125,V. HARI KUMAR,Independent,110,0,110,0.06,Anantapur Urban,153,Andhra Pradesh 
126,NOTA,None of the Above,1307,72,1379,0.73,Anantapur Urban,153,Andhra Pradesh 
127,YELLA SRINIVASA RAO,Indian National Congress,1276,24,1300,0.66,Anaparthy ,40,Andhra Pradesh 
128,KOLLAM SRINU,Bahujan Samaj Party,306,2,308,0.16,Anaparthy ,40,Andhra Pradesh 
129,RAMAKRISHNA REDDY NALLAMILLI,Bharatiya Janata Party,104705,1015,105720,53.73,Anaparthy ,40,Andhra Pradesh 
130,DOCTOR.SATHI SURYANARAYANA REDDY,Yuvajana Sramika Rythu Congress Party,84138,732,84870,43.14,Anaparthy ,40,Andhra Pradesh 
131,KOVVURI SIVANANDA REDDY,Akhil Bharatiya Jan Sangh,289,1,290,0.15,Anaparthy ,40,Andhra Pradesh 
132,GANGADHAR LINGAM,Jaibhim Rao Bharat Party,269,2,271,0.14,Anaparthy ,40,Andhra Pradesh 
133,SHEK SARDHAR HUSSEN,Liberation Congress Party,284,1,285,0.14,Anaparthy ,40,Andhra Pradesh 
134,CHELLE SRINU,Independent,275,3,278,0.14,Anaparthy ,40,Andhra Pradesh 
135,PULAGAM SURREDDY,Independent,327,0,327,0.17,Anaparthy ,40,Andhra Pradesh 
136,NOTA,None of the Above,3093,12,3105,1.58,Anaparthy ,40,Andhra Pradesh 
137,KAMBHAM RAJU BABU,Bahujan Samaj Party,423,9,432,0.24,Kakinada City,41,Andhra Pradesh 
138,CHEKKA NOOKARAJU,Indian National Congress,2100,38,2138,1.21,Kakinada City,41,Andhra Pradesh 
139,DWARAMPUDI CHANDRASEKHARA REDDY,Yuvajana Sramika Rythu Congress Party,55590,852,56442,31.86,Kakinada City,41,Andhra Pradesh 
140,VANAMADI VENKATESWARA RAO @ KONDABABU,Telugu Desam,111068,1946,113014,63.78,Kakinada City,41,Andhra Pradesh 
141,KATRU NAGABABU,Telugu Nava Garjana Party,325,2,327,0.18,Kakinada City,41,Andhra Pradesh 
142,CHAKRAVARTHI GINJALA,Jaibhim Rao Bharat Party,107,2,109,0.06,Kakinada City,41,Andhra Pradesh 
143,MUNAGALA SAI GOPI,Telugu Janata Party,100,0,100,0.06,Kakinada City,41,Andhra Pradesh 
144,LEELA SURYA KIRAN YANAMANDRA,Pyramid Party of India,259,1,260,0.15,Kakinada City,41,Andhra Pradesh 
145,M.VENKATESWARA RAO (BANDABABU),Navarang Congress Party,1708,2,1710,0.97,Kakinada City,41,Andhra Pradesh 
146,V.VENKATESWARA RAO (KONDABABU),Jatiya Jana Sena Party,286,4,290,0.16,Kakinada City,41,Andhra Pradesh 
147,KASIMKOTA CHANDRASEKHAR,Independent,118,0,118,0.07,Kakinada City,41,Andhra Pradesh 
148,M.PRABHAKARA RAO,Independent,114,2,116,0.07,Kakinada City,41,Andhra Pradesh 
149,B.BAIRAVASWAMY,Independent,138,1,139,0.08,Kakinada City,41,Andhra Pradesh 
150,T.SRINIVASA RAO,Independent,372,0,372,0.21,Kakinada City,41,Andhra Pradesh 
151,SATISH KUMAR,Independent,171,0,171,0.1,Kakinada City,41,Andhra Pradesh 
152,NOTA,None of the Above,1419,27,1446,0.82,Kakinada City,41,Andhra Pradesh 
153,KOTA. SRINIVAS RAO,Indian National Congress,1157,16,1173,0.67,Ramachandrapuram,42,Andhra Pradesh 
154,PILLI SURYA PRAKASH,Yuvajana Sramika Rythu Congress Party,70629,732,71361,40.69,Ramachandrapuram,42,Andhra Pradesh 
155,MATHA RANI SUBRAHMANYAM,Bahujan Samaj Party,1188,18,1206,0.69,Ramachandrapuram,42,Andhra Pradesh 
156,VASAMSETTI. SUBASH,Telugu Desam,96149,1503,97652,55.68,Ramachandrapuram,42,Andhra Pradesh 
157,JUTTUKA VENKATARAO,Pyramid Party of India,490,1,491,0.28,Ramachandrapuram,42,Andhra Pradesh 
158,BARLA SRINIVAS YADAV,Bharatha Chaitanya Yuvajana Party,92,1,93,0.05,Ramachandrapuram,42,Andhra Pradesh 
159,KATE SUBRAHMANYAM,Independent,52,1,53,0.03,Ramachandrapuram,42,Andhra Pradesh 
160,KOYYA BANGARU BABU,Independent,52,2,54,0.03,Ramachandrapuram,42,Andhra Pradesh 
161,CHANDRA SEKHAR MADIKI,Independent,78,0,78,0.04,Ramachandrapuram,42,Andhra Pradesh 
162,JHAI SREE SUREYENDRA NADHA BABUJI SREEGUTHULA,Independent,1070,9,1079,0.62,Ramachandrapuram,42,Andhra Pradesh 
163,YARRAMSETTI RAMARAJU,Independent,245,1,246,0.14,Ramachandrapuram,42,Andhra Pradesh 
164,LANKA. PRAVEEN KUMAR,Independent,121,1,122,0.07,Ramachandrapuram,42,Andhra Pradesh 
165,SUJATA CHEKKA,Independent,172,0,172,0.1,Ramachandrapuram,42,Andhra Pradesh 
166,NOTA,None of the Above,1595,13,1608,0.92,Ramachandrapuram,42,Andhra Pradesh 
167,DATLA SUBBARAJU (BUCHIBABU),Telugu Desam,117233,1454,118687,57.25,Mummidivaram,43,Andhra Pradesh 
168,PALEPU DHARMA RAO,Indian National Congress,1330,12,1342,0.65,Mummidivaram,43,Andhra Pradesh 
169,PONNADA VENKATA SATISH KUMAR,Yuvajana Sramika Rythu Congress Party,79298,653,79951,38.56,Mummidivaram,43,Andhra Pradesh 
170,BHIMARAO VAKAPALLI,Bahujan Samaj Party,2746,36,2782,1.34,Mummidivaram,43,Andhra Pradesh 
171,DADALA RAMA KRISHNA,Republican Party of India,263,6,269,0.13,Mummidivaram,43,Andhra Pradesh 
172,PEMMADI SWAMI,All India Forward Bloc,107,0,107,0.05,Mummidivaram,43,Andhra Pradesh 
173,BABJI VANACHARLA,Jai Bharat National Party,93,1,94,0.05,Mummidivaram,43,Andhra Pradesh 
174,MALLADI KRISHNARAO,Telugu Nava Garjana Party,152,1,153,0.07,Mummidivaram,43,Andhra Pradesh 
175,R. MAHA LAKSHMI,Pyramid Party of India,200,0,200,0.1,Mummidivaram,43,Andhra Pradesh 
176,ANGADI REVATHI,Independent,743,3,746,0.36,Mummidivaram,43,Andhra Pradesh 
177,TEKUMUDI VENKATA RAO,Independent,98,0,98,0.05,Mummidivaram,43,Andhra Pradesh 
178,DONGA SATYA RAM,Independent,93,1,94,0.05,Mummidivaram,43,Andhra Pradesh 
179,RAVI KUMAR CHEEKURUMELLI,Independent,205,0,205,0.1,Mummidivaram,43,Andhra Pradesh 
180,RAYUDU SRIRAMA CHANDRA MURTHY,Independent,446,1,447,0.22,Mummidivaram,43,Andhra Pradesh 
181,SATTIRAJU SWAMY,Independent,281,0,281,0.14,Mummidivaram,43,Andhra Pradesh 
182,NOTA,None of the Above,1857,8,1865,0.9,Mummidivaram,43,Andhra Pradesh 
183,GOLLAPALLI SURYA RAO,Yuvajana Sramika Rythu Congress Party,55711,792,56503,35.57,Razole ,45,Andhra Pradesh 
184,PULAPAKURA LILINI ASHA RANI,Bahujan Samaj Party,1066,29,1095,0.69,Razole ,45,Andhra Pradesh 
185,SARELLA PRASANNA KUMAR,Indian National Congress,1404,31,1435,0.9,Razole ,45,Andhra Pradesh 
186,DEVA VARAPRASAD,Janasena Party,93952,1562,95514,60.13,Razole ,45,Andhra Pradesh 
187,YARLAGADDA KRISHNA,Pyramid Party of India,754,1,755,0.48,Razole ,45,Andhra Pradesh 
188,VENKATA PRASAD MANUKONDA M.A,Jatiya Jana Sena Party,316,0,316,0.2,Razole ,45,Andhra Pradesh 
189,KONDETI PRABHAKARAA REDDY,Independent,143,1,144,0.09,Razole ,45,Andhra Pradesh 
190,POTHUMUDI ALIVELU MANGATAYARU,Independent,279,3,282,0.18,Razole ,45,Andhra Pradesh 
191,BODDAPALLI NAGESWARA RAO,Independent,352,0,352,0.22,Razole ,45,Andhra Pradesh 
192,MATHI JAYA PRAKASH,Independent,815,1,816,0.51,Razole ,45,Andhra Pradesh 
193,NOTA,None of the Above,1607,21,1628,1.02,Razole ,45,Andhra Pradesh 
194,ASHOK BENDALAM,Telugu Desam,108738,1874,110612,58.58,Ichchapuram,1,Andhra Pradesh 
195,PIRIYA VIJAYA,Yuvajana Sramika Rythu Congress Party,70130,699,70829,37.51,Ichchapuram,1,Andhra Pradesh 
196,BISAI VEDAVARA,Bahujan Samaj Party,625,9,634,0.34,Ichchapuram,1,Andhra Pradesh 
197,MASUPATRI CHAKRAVARTHI REDDY,Indian National Congress,760,32,792,0.42,Ichchapuram,1,Andhra Pradesh 
198,BADDI MUKHALINGAM,Bharatha Chaitanya Yuvajana Party,165,4,169,0.09,Ichchapuram,1,Andhra Pradesh 
199,VISWANADHAM LABALA,Jaibhim Rao Bharat Party,161,2,163,0.09,Ichchapuram,1,Andhra Pradesh 
200,MURAPALA LAKSHMI,Independent,211,5,216,0.11,Ichchapuram,1,Andhra Pradesh 
201,SUGGU CHAKRAVARTHI,Independent,279,5,284,0.15,Ichchapuram,1,Andhra Pradesh 
202,SURYA VARA PRASADA RAO JANNELA,Independent,736,6,742,0.39,Ichchapuram,1,Andhra Pradesh 
203,NOTA,None of the Above,4345,29,4374,2.32,Ichchapuram,1,Andhra Pradesh 
204,APPALARAJU SEEDIRI,Yuvajana Sramika Rythu Congress Party,60305,905,61210,36.43,Palasa,2,Andhra Pradesh 
205,GOUTHU SIREESHA,Telugu Desam,99588,1972,101560,60.44,Palasa,2,Andhra Pradesh 
206,TRINATH BABU MAJJI,Indian National Congress,999,65,1064,0.63,Palasa,2,Andhra Pradesh 
207,NAGIRI SRINIVASA RAO,Bahujan Samaj Party,260,15,275,0.16,Palasa,2,Andhra Pradesh 
208,ANIL RAJU GMS,Jai Bharat National Party,116,7,123,0.07,Palasa,2,Andhra Pradesh 
209,APPALARAJU MOTURU,Bharatha Chaitanya Yuvajana Party,64,1,65,0.04,Palasa,2,Andhra Pradesh 
210,KAMESWARARAO POTANAPALLI,Communist Party of India (Marxist-Leninist) (Liberation),152,3,155,0.09,Palasa,2,Andhra Pradesh 
211,KARNI.VENKATARAMANA MURTY,Independent,139,3,142,0.08,Palasa,2,Andhra Pradesh 
212,TELAGAVALASA JAYARAM,Independent,322,0,322,0.19,Palasa,2,Andhra Pradesh 
213,D.VEERASWAMI,Independent,352,5,357,0.21,Palasa,2,Andhra Pradesh 
214,NOTA,None of the Above,2742,20,2762,1.64,Palasa,2,Andhra Pradesh 
215,ATCHANNAIDU KINJARAPU,Telugu Desam,105182,2741,107923,55.71,Tekkali ,3,Andhra Pradesh 
216,KILLI KRUPA RANI,Indian National Congress,2577,107,2684,1.39,Tekkali ,3,Andhra Pradesh 
217,CHINTADA SRINIVASA RAO,Bahujan Samaj Party,781,13,794,0.41,Tekkali ,3,Andhra Pradesh 
218,DUVVADA SRINIVAS,Yuvajana Sramika Rythu Congress Party,72282,1206,73488,37.94,Tekkali ,3,Andhra Pradesh 
219,BYPALLI PARAMESWARARAO,Jai Bharat National Party,377,9,386,0.2,Tekkali ,3,Andhra Pradesh 
220,ATTADA RAJESH,Independent,603,11,614,0.32,Tekkali ,3,Andhra Pradesh 
221,GEDDAVALASA RAMU,Independent,475,7,482,0.25,Tekkali ,3,Andhra Pradesh 
222,NOTA,None of the Above,3660,3682,7342,3.79,Tekkali ,3,Andhra Pradesh 
223,KOPPURAUTU VENKATA RAO,Indian National Congress,3502,63,3565,2.18,Pathapatnam ,4,Andhra Pradesh 
224,BODDEPALLI KRISHNA RAO,Bahujan Samaj Party,1695,9,1704,1.04,Pathapatnam ,4,Andhra Pradesh 
225,MAMIDI GOVINDA RAO,Telugu Desam,87273,2179,89452,54.77,Pathapatnam ,4,Andhra Pradesh 
226,REDDY SHANTHI,Yuvajana Sramika Rythu Congress Party,62035,890,62925,38.53,Pathapatnam ,4,Andhra Pradesh 
227,GOLLA TIRUPATHI RAO,Jai Bharat National Party,362,6,368,0.23,Pathapatnam ,4,Andhra Pradesh 
228,JANNI SANJEEVA RAO,Gondwana Dandkaranya Party,384,39,423,0.26,Pathapatnam ,4,Andhra Pradesh 
229,ASAPANNA SANKARA RAO,Independent,113,0,113,0.07,Pathapatnam ,4,Andhra Pradesh 
230,KOYYANA GOVINDA RAO,Independent,245,0,245,0.15,Pathapatnam ,4,Andhra Pradesh 
231,BAGGU KRUSHNA,Independent,327,1,328,0.2,Pathapatnam ,4,Andhra Pradesh 
232,R.MOHANA RAO,Independent,606,2,608,0.37,Pathapatnam ,4,Andhra Pradesh 
233,NOTA,None of the Above,3584,20,3604,2.21,Pathapatnam ,4,Andhra Pradesh 
234,AMBATI KRISHNA RAO,Indian National Congress,4270,83,4353,2.27,Srikakulam ,5,Andhra Pradesh 
235,GUJJALA SURYANARAYANA,Bahujan Samaj Party,1375,13,1388,0.72,Srikakulam ,5,Andhra Pradesh 
236,GONDU SHANKAR,Telugu Desam,113455,3636,117091,60.93,Srikakulam ,5,Andhra Pradesh 
237,DHARMANA PRASADA RAO,Yuvajana Sramika Rythu Congress Party,62862,1708,64570,33.6,Srikakulam ,5,Andhra Pradesh 
238,KARI LAKSHMANA,Pyramid Party of India,306,2,308,0.16,Srikakulam ,5,Andhra Pradesh 
239,PANILI PRASAD,Bharatha Chaitanya Yuvajana Party,610,5,615,0.32,Srikakulam ,5,Andhra Pradesh 
240,RAGOLU NAGASIVA,Jai Bharat National Party,463,7,470,0.24,Srikakulam ,5,Andhra Pradesh 
241,NOTA,None of the Above,3313,60,3373,1.76,Srikakulam ,5,Andhra Pradesh 
242,ESWARA RAO NADUKUDITI,Bharatiya Janata Party,111024,1746,112770,54.59,Etcherla ,7,Andhra Pradesh 
243,KARIMAJJI MALLESWARA RAO,Indian National Congress,2415,37,2452,1.19,Etcherla ,7,Andhra Pradesh 
244,KIRAN KUMAR GORLE,Yuvajana Sramika Rythu Congress Party,82777,904,83681,40.51,Etcherla ,7,Andhra Pradesh 
245,GANTLANA RAMARAO,Bahujan Samaj Party,877,7,884,0.43,Etcherla ,7,Andhra Pradesh 
246,KONETI NEELACHALAM,Pyramid Party of India,183,1,184,0.09,Etcherla ,7,Andhra Pradesh 
247,BARRI KORLAYYA,Jai Bharat National Party,217,0,217,0.11,Etcherla ,7,Andhra Pradesh 
248,NADUPURU ESWARA RAO,Independent,598,3,601,0.29,Etcherla ,7,Andhra Pradesh 
249,GORLE KIRAN KUMAR,Independent,300,3,303,0.15,Etcherla ,7,Andhra Pradesh 
250,GORLE RAMBABU,Independent,679,0,679,0.33,Etcherla ,7,Andhra Pradesh 
251,RAMYA SUVVARU,Independent,830,9,839,0.41,Etcherla ,7,Andhra Pradesh 
252,NOTA,None of the Above,3938,14,3952,1.91,Etcherla ,7,Andhra Pradesh 
253,KRISHNADAS DHARMANA,Yuvajana Sramika Rythu Congress Party,69281,1299,70580,39.79,Narasannapeta ,8,Andhra Pradesh 
254,MANTHRI NARASIMHAMURTHY,Indian National Congress,2180,45,2225,1.25,Narasannapeta ,8,Andhra Pradesh 
255,BAGGU RAMANAMURTHY,Telugu Desam,97394,2557,99951,56.35,Narasannapeta ,8,Andhra Pradesh 
256,KAYA KAMESWARI,Navarang Congress Party,420,12,432,0.24,Narasannapeta ,8,Andhra Pradesh 
257,CHEEPURU RAVI,Jai Bharat National Party,254,11,265,0.15,Narasannapeta ,8,Andhra Pradesh 
258,BORA VENKATA SATYENDRANATH ABIHISHEK,Independent,329,3,332,0.19,Narasannapeta ,8,Andhra Pradesh 
259,MYLAPALLI JAGADEESH,Independent,291,0,291,0.16,Narasannapeta ,8,Andhra Pradesh 
260,NOTA,None of the Above,3279,21,3300,1.86,Narasannapeta ,8,Andhra Pradesh 
261,KAMBALA RAJAVARDHANA,Indian National Congress,3655,29,3684,2.09,Rajam ,9,Andhra Pradesh 
262,KONDRU MURALI MOHAN,Telugu Desam,92105,2280,94385,53.48,Rajam ,9,Andhra Pradesh 
263,DR. TALE RAJESH,Yuvajana Sramika Rythu Congress Party,72752,911,73663,41.74,Rajam ,9,Andhra Pradesh 
264,BOCCHA BUDDUDU,Bahujan Samaj Party,514,10,524,0.3,Rajam ,9,Andhra Pradesh 
265,KUPPILI CHAITANYAKUMAR,Jai Bharat National Party,163,4,167,0.09,Rajam ,9,Andhra Pradesh 
266,PODUGU RAMAKRISHNA,Jaibhim Rao Bharat Party,185,0,185,0.1,Rajam ,9,Andhra Pradesh 
267,YENNI RAJU,Independent,461,5,466,0.26,Rajam ,9,Andhra Pradesh 
268,GANDI APPARAO,Independent,220,0,220,0.12,Rajam ,9,Andhra Pradesh 
269,MAJJI GANAPATHI,Independent,343,1,344,0.19,Rajam ,9,Andhra Pradesh 
270,MANNENA RAMESH,Independent,319,1,320,0.18,Rajam ,9,Andhra Pradesh 
271,NOTA,None of the Above,2522,14,2536,1.44,Rajam ,9,Andhra Pradesh 
272,CHANTI BABU SAVARA,Indian National Congress,1981,60,2041,1.38,Palakonda ,10,Andhra Pradesh 
273,VISWASARAYI KALAVATHI,Yuvajana Sramika Rythu Congress Party,61115,802,61917,41.73,Palakonda ,10,Andhra Pradesh 
274,VOOYAKA. BHANU CHANDAR,Bahujan Samaj Party,1567,3,1570,1.06,Palakonda ,10,Andhra Pradesh 
275,KRISHNA NIMMAKA,Jatiya Jana Sena Party,1340,23,1363,0.92,Palakonda ,10,Andhra Pradesh 
276,JAYAKRISHNA NIMMAKA,Janasena Party,73351,1857,75208,50.69,Palakonda ,10,Andhra Pradesh 
277,JAIPALU KADRAKA,Navarang Congress Party,1024,1,1025,0.69,Palakonda ,10,Andhra Pradesh 
278,BIDDIKA UMA MAHESWARA RAO,Gondwana Dandkaranya Party,964,27,991,0.67,Palakonda ,10,Andhra Pradesh 
279,NOTA,None of the Above,4248,12,4260,2.87,Palakonda ,10,Andhra Pradesh 
280,JAGADEESWARI THOYAKA,Telugu Desam,81186,2169,83355,53.68,Kurupam ,11,Andhra Pradesh 
281,TADANGI MINNARAO,Bahujan Samaj Party,1424,8,1432,0.92,Kurupam ,11,Andhra Pradesh 
282,PAMULA PUSHPA SREEVANI,Yuvajana Sramika Rythu Congress Party,59260,595,59855,38.54,Kurupam ,11,Andhra Pradesh 
283,MANDANGI RAMANA,Communist Party of India (Marxist),3868,55,3923,2.53,Kurupam ,11,Andhra Pradesh 
284,ADDAKULA GEETHARANI,Independent,763,4,767,0.49,Kurupam ,11,Andhra Pradesh 
285,TADANGI SRIHARI RAO NAIDU,Independent,502,6,508,0.33,Kurupam ,11,Andhra Pradesh 
286,MOSURU NAGA BUSHAN,Independent,689,1,690,0.44,Kurupam ,11,Andhra Pradesh 
287,NOTA,None of the Above,4753,8,4761,3.07,Kurupam ,11,Andhra Pradesh 
288,ALAJANGI JOGARAO,Yuvajana Sramika Rythu Congress Party,58618,873,59491,39.23,Parvathipuram ,12,Andhra Pradesh 
289,KUPPILI VENKATA RAMANA,Bahujan Samaj Party,947,7,954,0.63,Parvathipuram ,12,Andhra Pradesh 
290,BATHINA MOHANARAO,Indian National Congress,1614,26,1640,1.08,Parvathipuram ,12,Andhra Pradesh 
291,BONELA VIJAYA CHANDRA,Telugu Desam,81988,1917,83905,55.33,Parvathipuram ,12,Andhra Pradesh 
292,GUNTA JYOTHI,Jaibhim Rao Bharat Party,625,1,626,0.41,Parvathipuram ,12,Andhra Pradesh 
293,POTNURU KIRAN KUMAR(RAJ KIRAN),Jai Bharat National Party,295,4,299,0.2,Parvathipuram ,12,Andhra Pradesh 
294,UDAYA BHANU GARBHAPU,Independent,641,13,654,0.43,Parvathipuram ,12,Andhra Pradesh 
295,GARBHAPU MOHANA RAO,Independent,599,0,599,0.4,Parvathipuram ,12,Andhra Pradesh 
296,NOTA,None of the Above,3456,9,3465,2.29,Parvathipuram ,12,Andhra Pradesh 
297,GUMMIDI SANDHYARANI,Telugu Desam,78872,1339,80211,50.65,Salur ,13,Andhra Pradesh 
298,MUVVALA GNANAPRAKASAM,Bahujan Samaj Party,1368,4,1372,0.87,Salur ,13,Andhra Pradesh 
299,MUVVALA PUSPHARAO,Indian National Congress,2225,14,2239,1.41,Salur ,13,Andhra Pradesh 
300,RAJANNA DORA PEEDIKA,Yuvajana Sramika Rythu Congress Party,65814,664,66478,41.98,Salur ,13,Andhra Pradesh 
301,PUSURU SAI,Samajwadi Party,748,1,749,0.47,Salur ,13,Andhra Pradesh 
302,KANCHURI BANGARU RAJU,Independent,685,1,686,0.43,Salur ,13,Andhra Pradesh 
303,KELLA MURALI,Independent,877,0,877,0.55,Salur ,13,Andhra Pradesh 
304,NOTA,None of the Above,5735,8,5743,3.63,Salur ,13,Andhra Pradesh 
305,MARIPI VIDYASAGAR (VINAY),Indian National Congress,4753,29,4782,2.53,Bobbili ,14,Andhra Pradesh 
306,R.V.S.K.K.RANGA RAO @ BABYNAYANA,Telugu Desam,110111,2255,112366,59.45,Bobbili ,14,Andhra Pradesh 
307,VENKATA CHINA APPALA NAIDU SAMBANGI,Yuvajana Sramika Rythu Congress Party,66875,843,67718,35.83,Bobbili ,14,Andhra Pradesh 
308,SAVALAPURAM RAMANA,Bahujan Samaj Party,596,3,599,0.32,Bobbili ,14,Andhra Pradesh 
309,KIRAN KUMAR. REDDY,Samajwadi Party,173,2,175,0.09,Bobbili ,14,Andhra Pradesh 
310,MARADANA. VENKATA NAIDU,Jaibhim Rao Bharat Party,232,2,234,0.12,Bobbili ,14,Andhra Pradesh 
311,PRASANTH AKETI,Independent,327,3,330,0.17,Bobbili ,14,Andhra Pradesh 
312,MARRAPU BHANU MURTY.,Independent,259,0,259,0.14,Bobbili ,14,Andhra Pradesh 
313,NOTA,None of the Above,2551,10,2561,1.35,Bobbili ,14,Andhra Pradesh 
314,AADINARAYANA JAMMU,Indian National Congress,4075,12,4087,2.36,Cheepurupalle ,15,Andhra Pradesh 
315,KALAVENKATARAO KIMIDI,Telugu Desam,87083,1142,88225,50.98,Cheepurupalle ,15,Andhra Pradesh 
316,BOTCHA SATYANARAYANA,Yuvajana Sramika Rythu Congress Party,75444,810,76254,44.06,Cheepurupalle ,15,Andhra Pradesh 
317,SABBI SATYANARAYANA,Bahujan Samaj Party,519,1,520,0.3,Cheepurupalle ,15,Andhra Pradesh 
318,ADAPAKA SURIBABU,Reforms Party of India,207,0,207,0.12,Cheepurupalle ,15,Andhra Pradesh 
319,KANIGIRI SRINIVASARAO,Jaibhim Rao Bharat Party,466,2,468,0.27,Cheepurupalle ,15,Andhra Pradesh 
320,GURUGUBELLI APPALANAIDU,Independent,438,1,439,0.25,Cheepurupalle ,15,Andhra Pradesh 
321,NOTA,None of the Above,2848,7,2855,1.65,Cheepurupalle ,15,Andhra Pradesh 
322,APPALANARASAYYA BOTCHA,Yuvajana Sramika Rythu Congress Party,71914,836,72750,40.8,Gajapathinagaram ,16,Andhra Pradesh 
323,KONDAPALLI SRINIVAS,Telugu Desam,96313,1738,98051,54.99,Gajapathinagaram ,16,Andhra Pradesh 
324,CHELLUBOINA SRINU,Bahujan Samaj Party,781,5,786,0.44,Gajapathinagaram ,16,Andhra Pradesh 
325,DOLA. SRINIVAS,Indian National Congress,1298,17,1315,0.74,Gajapathinagaram ,16,Andhra Pradesh 
326,KAKARLAPUDI SANDHYA,Pyramid Party of India,139,1,140,0.08,Gajapathinagaram ,16,Andhra Pradesh 
327,KILAPARTHI KUMAR RAJA,Samajwadi Party,171,2,173,0.1,Gajapathinagaram ,16,Andhra Pradesh 
328,KOTTHALI GOWRI NAIDU,Naba Bharata Nirmana Seva Party,185,0,185,0.1,Gajapathinagaram ,16,Andhra Pradesh 
329,PENTA SANKARARAO,Jaibhim Rao Bharat Party,140,3,143,0.08,Gajapathinagaram ,16,Andhra Pradesh 
330,LENKA SURYARAO,Jai Bharat Party,133,0,133,0.07,Gajapathinagaram ,16,Andhra Pradesh 
331,APPALANAIDU KILARI,Independent,133,1,134,0.08,Gajapathinagaram ,16,Andhra Pradesh 
332,KURMINAIDU GADAPU,Independent,157,0,157,0.09,Gajapathinagaram ,16,Andhra Pradesh 
333,TALUPULA. SANKAR RAO,Independent,230,0,230,0.13,Gajapathinagaram ,16,Andhra Pradesh 
334,MULAGADA DURGA RAO,Independent,387,0,387,0.22,Gajapathinagaram ,16,Andhra Pradesh 
335,NOTA,None of the Above,3712,17,3729,2.09,Gajapathinagaram ,16,Andhra Pradesh 
336,APPALANAIDU BADDUKONDA,Yuvajana Sramika Rythu Congress Party,69409,677,70086,36.83,Nellimarla ,17,Andhra Pradesh 
337,YERUKONDA TEJA RANI,Bahujan Samaj Party,1376,20,1396,0.73,Nellimarla ,17,Andhra Pradesh 
338,SARAGADA RAMESH KUMAR,Indian National Congress,1638,29,1667,0.88,Nellimarla ,17,Andhra Pradesh 
339,ADAPAKA SURIBABU,Reforms Party of India,431,2,433,0.23,Nellimarla ,17,Andhra Pradesh 
340,KARRI KRISHAN,Samajwadi Party,271,2,273,0.14,Nellimarla ,17,Andhra Pradesh 
341,TOMPALA NARASAYYA,Jaibhim Rao Bharat Party,299,1,300,0.16,Nellimarla ,17,Andhra Pradesh 
342,NADIPENA SRINU,Akhil Bharatiya Jan Sangh,312,5,317,0.17,Nellimarla ,17,Andhra Pradesh 
343,MAJJI NAGAMANI,Jatiya Jana Sena Party,298,10,308,0.16,Nellimarla ,17,Andhra Pradesh 
344,LENKA MADHAVI,Navarang Congress Party,1438,7,1445,0.76,Nellimarla ,17,Andhra Pradesh 
345,LOKAM NAGA MADHAVI,Janasena Party,108319,1596,109915,57.75,Nellimarla ,17,Andhra Pradesh 
346,KANDAMMATIL JAYESH,Independent,406,0,406,0.21,Nellimarla ,17,Andhra Pradesh 
347,PASUPULETI SATYA PRASAD BABU,Independent,463,0,463,0.24,Nellimarla ,17,Andhra Pradesh 
348,NOTA,None of the Above,3299,6,3305,1.74,Nellimarla ,17,Andhra Pradesh 
349,ADITI VIJAYALAKSHMI GAJAPATHI RAJU PUSAPATI,Telugu Desam,117808,3433,121241,64.21,Vizianagaram ,18,Andhra Pradesh 
350,ARJI SIVAPRASAD,Bahujan Samaj Party,749,10,759,0.4,Vizianagaram ,18,Andhra Pradesh 
351,KOLAGATLA VEERABHADRA SWAMY,Yuvajana Sramika Rythu Congress Party,59350,1282,60632,32.11,Vizianagaram ,18,Andhra Pradesh 
352,SATISH KUMAR SUNKARI,Indian National Congress,1488,39,1527,0.81,Vizianagaram ,18,Andhra Pradesh 
353,KARUNAKAR PENUMATSA,Samajwadi Party,148,5,153,0.08,Vizianagaram ,18,Andhra Pradesh 
354,KALLA SURI BABU,Jatiya Jana Sena Party,42,3,45,0.02,Vizianagaram ,18,Andhra Pradesh 
355,MB. GURUNADHA. SHARMA,Yuga Thulasi Party,97,1,98,0.05,Vizianagaram ,18,Andhra Pradesh 
356,CHINTAPALLI. DURGARAO,Jaibhim Rao Bharat Party,86,0,86,0.05,Vizianagaram ,18,Andhra Pradesh 
357,POLIPALLI KIRAN KUMAR,Akhil Bharatiya Jan Sangh,69,0,69,0.04,Vizianagaram ,18,Andhra Pradesh 
358,GEETHA MEESALA,Independent,1961,93,2054,1.09,Vizianagaram ,18,Andhra Pradesh 
359,DUDDU VENKATA RAMANA,Independent,54,1,55,0.03,Vizianagaram ,18,Andhra Pradesh 
360,PADALA ADINARAYANA,Independent,68,0,68,0.04,Vizianagaram ,18,Andhra Pradesh 
361,PANDRINKI VENKATA RAMANA,Independent,102,0,102,0.05,Vizianagaram ,18,Andhra Pradesh 
362,BHASKARA RAO CHINTAPALI,Independent,363,0,363,0.19,Vizianagaram ,18,Andhra Pradesh 
363,SURESH KANDIVALASA,Independent,189,1,190,0.1,Vizianagaram ,18,Andhra Pradesh 
364,NOTA,None of the Above,1341,24,1365,0.72,Vizianagaram ,18,Andhra Pradesh 
365,KADUBANDI SRINIVASA RAO,Yuvajana Sramika Rythu Congress Party,71385,851,72236,37.97,Srungavarapukota ,19,Andhra Pradesh 
366,KOLLA LALITHA KUMARI,Telugu Desam,109110,1916,111026,58.36,Srungavarapukota ,19,Andhra Pradesh 
367,GEDELA TIRUPATI,Indian National Congress,1889,29,1918,1.01,Srungavarapukota ,19,Andhra Pradesh 
368,BONU KRISHNA,Bahujan Samaj Party,677,6,683,0.36,Srungavarapukota ,19,Andhra Pradesh 
369,VINNAKOTA JAGANNADHA RAO,Samajwadi Party,87,1,88,0.05,Srungavarapukota ,19,Andhra Pradesh 
370,VENKATA RAO YALLA,Jatiya Jana Sena Party,64,4,68,0.04,Srungavarapukota ,19,Andhra Pradesh 
371,GOLLA ESWARA RAO,Independent,113,1,114,0.06,Srungavarapukota ,19,Andhra Pradesh 
372,CHIPPADA SESHAGIRI RAO,Independent,146,8,154,0.08,Srungavarapukota ,19,Andhra Pradesh 
373,PIDIDHI ESWARAMMA,Independent,92,1,93,0.05,Srungavarapukota ,19,Andhra Pradesh 
374,BHASKARABHATLA PUSHPALATHA,Independent,147,1,148,0.08,Srungavarapukota ,19,Andhra Pradesh 
375,LOKABHI RAMAKOTI KOTYADA,Independent,1400,18,1418,0.75,Srungavarapukota ,19,Andhra Pradesh 
376,VARADI CHIRANJEEVI,Independent,338,1,339,0.18,Srungavarapukota ,19,Andhra Pradesh 
377,NOTA,None of the Above,1958,11,1969,1.03,Srungavarapukota ,19,Andhra Pradesh 
378,VENKATA VARMARAJU ADDALA,Indian National Congress,5073,74,5147,1.85,Bhimili ,20,Andhra Pradesh 
379,GANTA SRINIVASA RAO,Telugu Desam,173467,2763,176230,63.34,Bhimili ,20,Andhra Pradesh 
380,BAGAM GOPALA RAO,Bahujan Samaj Party,2504,19,2523,0.91,Bhimili ,20,Andhra Pradesh 
381,MUTTAMSETTI SRINIVASA RAO (AVANTHI SRINIVAS),Yuvajana Sramika Rythu Congress Party,82732,1097,83829,30.13,Bhimili ,20,Andhra Pradesh 
382,ELIPILLI ANIL KUMAR,Jai Bharat National Party,591,9,600,0.22,Bhimili ,20,Andhra Pradesh 
383,KOLA HARIBABU,Republican Party of India (A),397,1,398,0.14,Bhimili ,20,Andhra Pradesh 
384,GANTA SRINIVASARAO,Jatiya Jana Sena Party,175,8,183,0.07,Bhimili ,20,Andhra Pradesh 
385,CHODIPALLI RAJU,Samajwadi Party,133,1,134,0.05,Bhimili ,20,Andhra Pradesh 
386,CHOPPALLI SARAVAN GANESH,Independent,393,0,393,0.14,Bhimili ,20,Andhra Pradesh 
387,NAGAMANI NAGOTU,Independent,255,4,259,0.09,Bhimili ,20,Andhra Pradesh 
388,NOOKALA SURYA PRAKASH,Independent,279,9,288,0.1,Bhimili ,20,Andhra Pradesh 
389,NANDIKOLLA SANDHYA,Independent,163,1,164,0.06,Bhimili ,20,Andhra Pradesh 
390,BAVISETTY RAMANA BABU,Independent,508,4,512,0.18,Bhimili ,20,Andhra Pradesh 
391,BUGATHA RAMU,Independent,4002,30,4032,1.45,Bhimili ,20,Andhra Pradesh 
392,MEKA SATHYA KIRAN,Independent,482,0,482,0.17,Bhimili ,20,Andhra Pradesh 
393,NOTA,None of the Above,3028,33,3061,1.1,Bhimili ,20,Andhra Pradesh 
394,GUTHULA SRINIVAS RAO,Indian National Congress,3379,51,3430,1.69,Visakhapatnam East,21,Andhra Pradesh 
395,JOSEPH PETER,Bahujan Samaj Party,483,11,494,0.24,Visakhapatnam East,21,Andhra Pradesh 
396,RAMAKRISHNA BABU VELAGAPUDI,Telugu Desam,129690,2357,132047,64.89,Visakhapatnam East,21,Andhra Pradesh 
397,M V V SATYANARAYANA,Yuvajana Sramika Rythu Congress Party,60061,1109,61170,30.06,Visakhapatnam East,21,Andhra Pradesh 
398,ADAPAKA DALI RAJU,Naba Bharata Nirmana Seva Party,242,4,246,0.12,Visakhapatnam East,21,Andhra Pradesh 
399,DR.GANAPATHI. KONGARAPU,Republican Party of India (A),161,1,162,0.08,Visakhapatnam East,21,Andhra Pradesh 
400,THOTA VENKATA SAI MUKUND,Praja Prasthanam Party,152,3,155,0.08,Visakhapatnam East,21,Andhra Pradesh 
401,YEDLA VENUGOPALA KRISHNA (SUMAN),Bharatha Chaitanya Yuvajana Party,90,2,92,0.05,Visakhapatnam East,21,Andhra Pradesh 
402,E. HYMAVATHI,Pyramid Party of India,85,1,86,0.04,Visakhapatnam East,21,Andhra Pradesh 
403,ANAGANI SHIVA RAMAKRISHNA,Independent,148,3,151,0.07,Visakhapatnam East,21,Andhra Pradesh 
404,ADADA RAMANI,Independent,130,1,131,0.06,Visakhapatnam East,21,Andhra Pradesh 
405,UMMIDI. BHASKAR RAO,Independent,150,0,150,0.07,Visakhapatnam East,21,Andhra Pradesh 
406,BARLA APPALA PADMAKAR YADAV,Independent,164,0,164,0.08,Visakhapatnam East,21,Andhra Pradesh 
407,VADDI SIRISHA,Independent,3487,21,3508,1.72,Visakhapatnam East,21,Andhra Pradesh 
408,NOTA,None of the Above,1495,13,1508,0.74,Visakhapatnam East,21,Andhra Pradesh 
409,KADIRI RAMU,Bahujan Samaj Party,924,8,932,0.67,Visakhapatnam South,22,Andhra Pradesh 
410,GANESH KUMAR VASUPALLI,Yuvajana Sramika Rythu Congress Party,32730,544,33274,23.88,Visakhapatnam South,22,Andhra Pradesh 
411,VASUPALLI SANTOSH KUMAR,Indian National Congress,3879,61,3940,2.83,Visakhapatnam South,22,Andhra Pradesh 
412,GUNTU .DURGA PRASAD,Bhartiya Rashtriya Dal,212,2,214,0.15,Visakhapatnam South,22,Andhra Pradesh 
413,BURA SRINIVASU RAO,Praja Prasthanam Party,108,0,108,0.08,Visakhapatnam South,22,Andhra Pradesh 
414,YERRAMSETTY SURESH KUMAR,Jai Bharat National Party,374,8,382,0.27,Visakhapatnam South,22,Andhra Pradesh 
415,RAVADA TATA RAO,Naba Bharata Nirmana Seva Party,232,0,232,0.17,Visakhapatnam South,22,Andhra Pradesh 
416,VAMSI KIRTHI KUMAR BUDDHAVARAPU,Jatiya Jana Sena Party,548,3,551,0.4,Visakhapatnam South,22,Andhra Pradesh 
417,CH.VAMSI KRISHNA SRINIVAS,Janasena Party,96586,1282,97868,70.24,Visakhapatnam South,22,Andhra Pradesh 
418,K. SRIDEVI,Jai Maha Bharath Party,118,0,118,0.08,Visakhapatnam South,22,Andhra Pradesh 
419,SURADA YELLAJI,Samajwadi Party,99,0,99,0.07,Visakhapatnam South,22,Andhra Pradesh 
420,KADAGALA ESWARARAO,Independent,66,0,66,0.05,Visakhapatnam South,22,Andhra Pradesh 
421,KILLAPARTHI MANGARATNAM,Independent,316,1,317,0.23,Visakhapatnam South,22,Andhra Pradesh 
422,DOLA JAGADESH,Independent,130,1,131,0.09,Visakhapatnam South,22,Andhra Pradesh 
423,THARAKARAM LAGISETTI.,Independent,194,0,194,0.14,Visakhapatnam South,22,Andhra Pradesh 
424,J.BIPIN KUMAR JAIN,Independent,271,0,271,0.19,Visakhapatnam South,22,Andhra Pradesh 
425,NOTA,None of the Above,614,17,631,0.45,Visakhapatnam South,22,Andhra Pradesh 
426,KANNAPARAJU KAMMILA (K.K. RAJU),Yuvajana Sramika Rythu Congress Party,60146,1121,61267,32.55,Visakhapatnam North,23,Andhra Pradesh 
427,PEDDADA KANAKAMAHALAKSHMI,Bahujan Samaj Party,924,14,938,0.5,Visakhapatnam North,23,Andhra Pradesh 
428,LAKKARAJU RAMA RAO,Indian National Congress,4174,78,4252,2.26,Visakhapatnam North,23,Andhra Pradesh 
429,VISHNU KUMAR RAJU PENMETSA,Bharatiya Janata Party,107128,1673,108801,57.81,Visakhapatnam North,23,Andhra Pradesh 
430,GUMPULA SARAT BABU,Samajwadi Party,394,1,395,0.21,Visakhapatnam North,23,Andhra Pradesh 
431,CHINTADA SURYAMU,Naba Bharata Nirmana Seva Party,231,0,231,0.12,Visakhapatnam North,23,Andhra Pradesh 
432,P. JAGADEESH,Jatiya Jana Sena Party,80,7,87,0.05,Visakhapatnam North,23,Andhra Pradesh 
433,LAKSHMI NARAYANA V.V. (J D LAKSHMI NARAYANA),Jai Bharat National Party,4960,200,5160,2.74,Visakhapatnam North,23,Andhra Pradesh 
434,KONETI ESWARA VEERA BHADRACHARI,Independent,77,0,77,0.04,Visakhapatnam North,23,Andhra Pradesh 
435,CHAPPA RAMUNAIDU,Independent,81,4,85,0.05,Visakhapatnam North,23,Andhra Pradesh 
436,BODDU SRINIVAS,Independent,102,2,104,0.06,Visakhapatnam North,23,Andhra Pradesh 
437,BORRA RAMESH,Independent,81,0,81,0.04,Visakhapatnam North,23,Andhra Pradesh 
438,YALAMANCHILI SAHITHI,Independent,112,1,113,0.06,Visakhapatnam North,23,Andhra Pradesh 
439,RONANKI CHALAPATHI RAO,Independent,176,0,176,0.09,Visakhapatnam North,23,Andhra Pradesh 
440,VADDI SIRISHA,Independent,5222,89,5311,2.82,Visakhapatnam North,23,Andhra Pradesh 
441,NOTA,None of the Above,1108,22,1130,0.6,Visakhapatnam North,23,Andhra Pradesh 
442,ATHUKUMSETTI RAMA CHANDRA RAO,Bahujan Samaj Party,1152,5,1157,0.77,Visakhapatnam West,24,Andhra Pradesh 
443,ADARI ANAND KUMAR,Yuvajana Sramika Rythu Congress Party,54998,623,55621,36.83,Visakhapatnam West,24,Andhra Pradesh 
444,P.G.V.R.NAIDU(GANABABU),Telugu Desam,89706,1099,90805,60.13,Visakhapatnam West,24,Andhra Pradesh 
445,ATHILI VIMALA,Communist Party of India,981,18,999,0.66,Visakhapatnam West,24,Andhra Pradesh 
446,BOTTA KOTESWARA RAO,Bharatha Chaitanya Yuvajana Party,137,0,137,0.09,Visakhapatnam West,24,Andhra Pradesh 
447,MANDAPATI SRINIVAS RAJU,Jatiya Jana Sena Party,159,6,165,0.11,Visakhapatnam West,24,Andhra Pradesh 
448,RAVI KUMAR VELAGADA,Samajwadi Party,69,0,69,0.05,Visakhapatnam West,24,Andhra Pradesh 
449,VENKATA GANESH JAGGUMANTRI,Jai Bharat National Party,414,9,423,0.28,Visakhapatnam West,24,Andhra Pradesh 
450,KOYELADA JAGADEESH,Independent,111,1,112,0.07,Visakhapatnam West,24,Andhra Pradesh 
451,JAMI PARVATHI,Independent,155,0,155,0.1,Visakhapatnam West,24,Andhra Pradesh 
452,PEDIREDLA NANAJI,Independent,71,2,73,0.05,Visakhapatnam West,24,Andhra Pradesh 
453,VINJAMURI KIRAN KUMAR,Independent,134,1,135,0.09,Visakhapatnam West,24,Andhra Pradesh 
454,HANUMANTHU SIVA CHANUKYA DORA,Independent,155,0,155,0.1,Visakhapatnam West,24,Andhra Pradesh 
455,NOTA,None of the Above,986,16,1002,0.66,Visakhapatnam West,24,Andhra Pradesh 
456,AVSS AMARNATH GUDIVADA,Yuvajana Sramika Rythu Congress Party,61529,939,62468,26.66,Gajuwaka ,25,Andhra Pradesh 
457,MARADANA JAGGUNAIDU,Communist Party of India (Marxist),3831,139,3970,1.69,Gajuwaka ,25,Andhra Pradesh 
458,APPARAO NANDIKOLLA,Bahujan Samaj Party,1123,11,1134,0.48,Gajuwaka ,25,Andhra Pradesh 
459,PALLA SRINIVAS RAO,Telugu Desam,155587,2116,157703,67.3,Gajuwaka ,25,Andhra Pradesh 
460,THOTA AKKAIAH,Loktantrik Janta Dal,537,0,537,0.23,Gajuwaka ,25,Andhra Pradesh 
461,KANDREGULA ADINARAYANA,Jai Maha Bharath Party,179,1,180,0.08,Gajuwaka ,25,Andhra Pradesh 
462,TALAPULA SAILAJA,Praja Prasthanam Party,121,1,122,0.05,Gajuwaka ,25,Andhra Pradesh 
463,ANAND KILARI,Praja Shanthi Party,1669,31,1700,0.73,Gajuwaka ,25,Andhra Pradesh 
464,BATHULA NEELAKANTAM,Naba Bharata Nirmana Seva Party,125,2,127,0.05,Gajuwaka ,25,Andhra Pradesh 
465,SAMUEL JOHN DHARMARAJU RAYAPATI,Dalita Bahujana Party,103,3,106,0.05,Gajuwaka ,25,Andhra Pradesh 
466,SUNKASURI SARAH JYOTHI,Navataram Party,136,2,138,0.06,Gajuwaka ,25,Andhra Pradesh 
467,KAKARLAMUDI KRISHNA PRADEEP,Independent,4285,31,4316,1.84,Gajuwaka ,25,Andhra Pradesh 
468,KOVIRI KRISHNA,Independent,130,3,133,0.06,Gajuwaka ,25,Andhra Pradesh 
469,SRINUVASA RAO SEEMAKURTHI,Independent,177,0,177,0.08,Gajuwaka ,25,Andhra Pradesh 
470,NOTA,None of the Above,1490,28,1518,0.65,Gajuwaka ,25,Andhra Pradesh 
471,KARANAM DHARMASRI,Yuvajana Sramika Rythu Congress Party,66706,756,67462,36.32,Chodavaram ,26,Andhra Pradesh 
472,JAGATA SRINIVASURAO,Indian National Congress,2496,31,2527,1.36,Chodavaram ,26,Andhra Pradesh 
473,VEGI MAHALAKSHMI NAIDU,Bahujan Samaj Party,1166,13,1179,0.63,Chodavaram ,26,Andhra Pradesh 
474,SURYA NAGA SANYASI RAJU KALIDINDI,Telugu Desam,107871,1780,109651,59.03,Chodavaram ,26,Andhra Pradesh 
475,SAVARALA GANESH,Communist Party of India (Marxist-Leninist) (Liberation),671,5,676,0.36,Chodavaram ,26,Andhra Pradesh 
476,PERICHRLA VIVEKA RAJU,Independent,394,3,397,0.21,Chodavaram ,26,Andhra Pradesh 
477,NOTA,None of the Above,3825,24,3849,2.07,Chodavaram ,26,Andhra Pradesh 
478,ANURADHA ERLI,Yuvajana Sramika Rythu Congress Party,63018,825,63843,38.64,Madugula ,27,Andhra Pradesh 
479,KARANAM TIRUPATHI RAO,Bahujan Samaj Party,1666,9,1675,1.01,Madugula ,27,Andhra Pradesh 
480,BODDU SRINIVASA,Indian National Congress,1760,24,1784,1.08,Madugula ,27,Andhra Pradesh 
481,BANDARU SATYANARAYANA MURTHY,Telugu Desam,90092,1777,91869,55.6,Madugula ,27,Andhra Pradesh 
482,THALLA. RAVI,Naba Bharata Nirmana Seva Party,532,0,532,0.32,Madugula ,27,Andhra Pradesh 
483,LEKKALA ESWARA RAO,Jaibhim Rao Bharat Party,379,3,382,0.23,Madugula ,27,Andhra Pradesh 
484,BUDI RAVI KUMAR,Independent,386,9,395,0.24,Madugula ,27,Andhra Pradesh 
485,MATHALA ARINAIDU,Independent,242,2,244,0.15,Madugula ,27,Andhra Pradesh 
486,MALLARAPU LOVACHAND,Independent,427,0,427,0.26,Madugula ,27,Andhra Pradesh 
487,NOTA,None of the Above,4060,10,4070,2.46,Madugula ,27,Andhra Pradesh 
488,GANGADHARASWAMI SETTY,Indian National Congress,11895,608,12503,6.99,Araku Valley,28,Andhra Pradesh 
489,RAJARAO PANGI,Bharatiya Janata Party,32933,848,33781,18.89,Araku Valley,28,Andhra Pradesh 
490,REGAM MATYALINGAM,Yuvajana Sramika Rythu Congress Party,64983,675,65658,36.71,Araku Valley,28,Andhra Pradesh 
491,LAKE RAJARAO,Bahujan Samaj Party,12814,692,13506,7.55,Araku Valley,28,Andhra Pradesh 
492,KILLO ANIL KUMAR,Liberation Congress Party,935,3,938,0.52,Araku Valley,28,Andhra Pradesh 
493,CHUNCHU RAJABABU,Gondwana Dandkaranya Party,947,8,955,0.53,Araku Valley,28,Andhra Pradesh 
494,BURIDI UPENDRA,Jai Bharat National Party,1206,0,1206,0.67,Araku Valley,28,Andhra Pradesh 
495,DR.RAMAKRISHNA PUCHAPUNDI,Bharat Adivasi Party,2054,6,2060,1.15,Araku Valley,28,Andhra Pradesh 
496,ABRAHAM SIVERI,Independent,11368,265,11633,6.5,Araku Valley,28,Andhra Pradesh 
497,ELIAH CHENDA,Independent,1199,84,1283,0.72,Araku Valley,28,Andhra Pradesh 
498,KAMMIDI NIRMALA,Independent,938,7,945,0.53,Araku Valley,28,Andhra Pradesh 
499,GEMMELI KRISHNARAO,Independent,1264,2,1266,0.71,Araku Valley,28,Andhra Pradesh 
500,NARAJI MADHU BABU,Independent,1419,3,1422,0.8,Araku Valley,28,Andhra Pradesh 
501,MOSIYA SUJATHA,Independent,2104,12,2116,1.18,Araku Valley,28,Andhra Pradesh 
502,RAGHUNADH SAMARDI,Independent,10555,182,10737,6,Araku Valley,28,Andhra Pradesh 
503,VANTHALA RAMANNA,Independent,13494,61,13555,7.58,Araku Valley,28,Andhra Pradesh 
504,SAMARDI BHAVANI,Independent,1675,20,1695,0.95,Araku Valley,28,Andhra Pradesh 
505,NOTA,None of the Above,3567,26,3593,2.01,Araku Valley,28,Andhra Pradesh 
506,APPA RAO SURLA,Bahujan Samaj Party,2646,27,2673,1.66,Paderu,29,Andhra Pradesh 
507,ESWARI GIDDI,Telugu Desam,47468,1364,48832,30.3,Paderu,29,Andhra Pradesh 
508,BULLIBABU SATAKA,Indian National Congress,13271,295,13566,8.42,Paderu,29,Andhra Pradesh 
509,MATSYARASA VISWESWARA RAJU,Yuvajana Sramika Rythu Congress Party,67333,837,68170,42.3,Paderu,29,Andhra Pradesh 
510,KILLO RANGA RAO,Bharatha Chaitanya Yuvajana Party,1174,4,1178,0.73,Paderu,29,Andhra Pradesh 
511,JOSEPH KINTUKURI,India Praja Bandhu Party,615,5,620,0.38,Paderu,29,Andhra Pradesh 
512,DUMANTHI NAGESWARARAO,Jai Bharat National Party,558,1,559,0.35,Paderu,29,Andhra Pradesh 
513,BONKU ARJUNARAO,Jai Maha Bharath Party,502,11,513,0.32,Paderu,29,Andhra Pradesh 
514,MINUMALA RAMBABU,Samajwadi Party,757,0,757,0.47,Paderu,29,Andhra Pradesh 
515,ADAPA VISHNU MURTHY,Independent,694,1,695,0.43,Paderu,29,Andhra Pradesh 
516,KOKKULA KANNABABU,Independent,1005,18,1023,0.63,Paderu,29,Andhra Pradesh 
517,CHETTI SANKARA RAO,Independent,742,16,758,0.47,Paderu,29,Andhra Pradesh 
518,CHERRIKI EPRAYAM BABU,Independent,1109,3,1112,0.69,Paderu,29,Andhra Pradesh 
519,DONKADA SIVA PRASAD,Independent,1432,2,1434,0.89,Paderu,29,Andhra Pradesh 
520,VALLA MOUNIKA,Independent,1910,5,1915,1.19,Paderu,29,Andhra Pradesh 
521,VANTHALA SUBBA RAO,Independent,15893,42,15935,9.89,Paderu,29,Andhra Pradesh 
522,NOTA,None of the Above,1408,12,1420,0.88,Paderu,29,Andhra Pradesh 
523,ANNAMREDDY ADEEP RAJ,Yuvajana Sramika Rythu Congress Party,66700,1041,67741,29.43,Pendurthi,31,Andhra Pradesh 
524,BANGARI . RAMANA,Bahujan Samaj Party,1299,9,1308,0.57,Pendurthi,31,Andhra Pradesh 
525,BHAGAT PIRIDI,Indian National Congress,4128,96,4224,1.84,Pendurthi,31,Andhra Pradesh 
526,EATHA ROJA,Pyramid Party of India,370,2,372,0.16,Pendurthi,31,Andhra Pradesh 
527,ELURU VENKATA RAMANA,Nationalist Janshakti Party,322,2,324,0.14,Pendurthi,31,Andhra Pradesh 
528,KANNEPALLI MAHADEV KALYAN SRIKANTH,Jai Bharat National Party,752,11,763,0.33,Pendurthi,31,Andhra Pradesh 
529,PANCHAKARLA RAMESH BABU,Janasena Party,146919,2692,149611,65.01,Pendurthi,31,Andhra Pradesh 
530,PETCHETTI RAMESH NAIDU,Navarang Congress Party,942,2,944,0.41,Pendurthi,31,Andhra Pradesh 
531,BOLEM VENKATA MURALI MOHAN,Samajwadi Party,300,2,302,0.13,Pendurthi,31,Andhra Pradesh 
532,ADARI NAGARAJU,Independent,235,0,235,0.1,Pendurthi,31,Andhra Pradesh 
533,KUNDRAPU SANYASI RAO,Independent,287,1,288,0.13,Pendurthi,31,Andhra Pradesh 
534,GUNTURU VENKATA NARASIMHA RAO,Independent,334,1,335,0.15,Pendurthi,31,Andhra Pradesh 
535,PONNADA APPALA NAIDU,Independent,316,0,316,0.14,Pendurthi,31,Andhra Pradesh 
536,VADDADI UDAYAKUMAR,Independent,545,2,547,0.24,Pendurthi,31,Andhra Pradesh 
537,NOTA,None of the Above,2794,40,2834,1.23,Pendurthi,31,Andhra Pradesh 
538,ANANTHA RAMA NARASINGARAO THANAKALA,Indian National Congress,1779,43,1822,1.02,Yelamanchili ,32,Andhra Pradesh 
539,UPPALAPATI VENKATA RAMANAMURTHY RAJU,Yuvajana Sramika Rythu Congress Party,59813,674,60487,33.71,Yelamanchili ,32,Andhra Pradesh 
540,LAMBA SRINUVASA RAO,Bahujan Samaj Party,1408,6,1414,0.79,Yelamanchili ,32,Andhra Pradesh 
541,B. AMMAJAMMA,Pyramid Party of India,349,3,352,0.2,Yelamanchili ,32,Andhra Pradesh 
542,ARJUN KUMAR SUNDARAPU,Navarang Congress Party,1250,2,1252,0.7,Yelamanchili ,32,Andhra Pradesh 
543,DADI PURNA CHANDRA RAO,Jai Bharat National Party,479,11,490,0.27,Yelamanchili ,32,Andhra Pradesh 
544,BOJA NAGESWARA RAO,Reforms Party of India,629,4,633,0.35,Yelamanchili ,32,Andhra Pradesh 
545,SUNDARAPU VIJAY KUMAR,Janasena Party,108080,1363,109443,61,Yelamanchili ,32,Andhra Pradesh 
546,PRAGADA ANNAPURNA,Independent,449,1,450,0.25,Yelamanchili ,32,Andhra Pradesh 
547,MOLLETI RAMESH,Independent,675,0,675,0.38,Yelamanchili ,32,Andhra Pradesh 
548,NOTA,None of the Above,2400,9,2409,1.34,Yelamanchili ,32,Andhra Pradesh 
549,ANITHA VANGALAPUDI,Telugu Desam,118675,1367,120042,57.86,Payakaraopet,33,Andhra Pradesh 
550,KAKARA NARASIMHARAO,Bahujan Samaj Party,1632,5,1637,0.79,Payakaraopet,33,Andhra Pradesh 
551,JOGULU KAMBALA,Yuvajana Sramika Rythu Congress Party,75614,701,76315,36.78,Payakaraopet,33,Andhra Pradesh 
552,DR.BONI TATA RAO,Indian National Congress,2059,28,2087,1.01,Payakaraopet,33,Andhra Pradesh 
553,KRISHNA SWAROOP VADLAMURI,Dalita Bahujana Party,1770,16,1786,0.86,Payakaraopet,33,Andhra Pradesh 
554,DULAPALLI NAGESWARARAO,Jai Bharat National Party,257,2,259,0.12,Payakaraopet,33,Andhra Pradesh 
555,PARAVADA RAMAKRISHNA,Prabuddha Republican Party,284,1,285,0.14,Payakaraopet,33,Andhra Pradesh 
556,BOORTHI.YESAYYA,Independent,540,3,543,0.26,Payakaraopet,33,Andhra Pradesh 
557,SETTIBATHULA DHARMARAJU,Independent,425,0,425,0.2,Payakaraopet,33,Andhra Pradesh 
558,NOTA,None of the Above,4090,17,4107,1.98,Payakaraopet,33,Andhra Pradesh 
559,AYYANNAPATRUDU CHINTAKAYALA,Telugu Desam,97961,1888,99849,54.6,Narsipatnam,34,Andhra Pradesh 
560,UMA SANKARA GANESH PETLA,Yuvajana Sramika Rythu Congress Party,74101,1072,75173,41.11,Narsipatnam,34,Andhra Pradesh 
561,BOTTA NAGARAJU,Bahujan Samaj Party,1226,18,1244,0.68,Narsipatnam,34,Andhra Pradesh 
562,RUTHALA SRIRAMA MURTHY,Indian National Congress,1068,20,1088,0.59,Narsipatnam,34,Andhra Pradesh 
563,CHANDRAMOULI JOGA,Bharatha Chaitanya Yuvajana Party,298,2,300,0.16,Narsipatnam,34,Andhra Pradesh 
564,NETHALA NAGESWARARAO,Jaibhim Rao Bharat Party,440,0,440,0.24,Narsipatnam,34,Andhra Pradesh 
565,PAILA SURYA GANESH,Independent,269,1,270,0.15,Narsipatnam,34,Andhra Pradesh 
566,BAYPUREDDI BHADRACHALAM,Independent,678,0,678,0.37,Narsipatnam,34,Andhra Pradesh 
567,NOTA,None of the Above,3810,14,3824,2.09,Narsipatnam,34,Andhra Pradesh 
568,KARRI NOOKARAJU,Bahujan Samaj Party,804,1,805,0.42,Tuni,35,Andhra Pradesh 
569,GELAM SRINIVASARAO,Indian National Congress,1908,15,1923,1.02,Tuni,35,Andhra Pradesh 
570,DADISETTI RAJA,Yuvajana Sramika Rythu Congress Party,81295,734,82029,43.3,Tuni,35,Andhra Pradesh 
571,DIVYA YANAMALA,Telugu Desam,95836,1370,97206,51.31,Tuni,35,Andhra Pradesh 
572,YADALA RAMAKRISHNA,Reforms Party of India,498,1,499,0.26,Tuni,35,Andhra Pradesh 
573,SIVA VADABOYINA,Communist Party of India (Marxist-Leninist) (Liberation),232,0,232,0.12,Tuni,35,Andhra Pradesh 
574,SATISH DUTHURTHI,Dalita Bahujana Party,390,0,390,0.21,Tuni,35,Andhra Pradesh 
575,ADI VENKATA SATYANARAYANA VEGI,Independent,301,1,302,0.16,Tuni,35,Andhra Pradesh 
576,KONA RAMAKRISHNA,Independent,1177,2,1179,0.62,Tuni,35,Andhra Pradesh 
577,TAMARANA APPARAO,Independent,1006,0,1006,0.53,Tuni,35,Andhra Pradesh 
578,BODAPATI SRINIVASARAO,Independent,439,1,440,0.23,Tuni,35,Andhra Pradesh 
579,NOTA,None of the Above,3416,18,3434,1.81,Tuni,35,Andhra Pradesh 
580,NEERUKONDA VEERA VENKATA SATYANARAYANA,Indian National Congress,1345,9,1354,0.77,Prathipadu ,36,Andhra Pradesh 
581,BURTHI SRINU BABU,Bahujan Samaj Party,755,0,755,0.43,Prathipadu ,36,Andhra Pradesh 
582,VARUPULA SATYA PRABHA,Telugu Desam,101856,1146,103002,58.36,Prathipadu ,36,Andhra Pradesh 
583,VARUPULA SUBBARAO,Yuvajana Sramika Rythu Congress Party,63810,424,64234,36.4,Prathipadu ,36,Andhra Pradesh 
584,ARJUNARAO YEGUPATI,Communist Party of India (Marxist-Leninist) (Liberation),579,0,579,0.33,Prathipadu ,36,Andhra Pradesh 
585,AASINA SRINIVAS,Pyramid Party of India,281,0,281,0.16,Prathipadu ,36,Andhra Pradesh 
586,YEDIDA VARAPRASAD KUMAR,Republican Party of India (A),166,0,166,0.09,Prathipadu ,36,Andhra Pradesh 
587,KONDABAABU NETALA,Dalita Bahujana Party,316,1,317,0.18,Prathipadu ,36,Andhra Pradesh 
588,GOMPA SIVA,Bharatha Chaitanya Yuvajana Party,688,2,690,0.39,Prathipadu ,36,Andhra Pradesh 
589,DADISETTY VEERABABU,Jaibhim Rao Bharat Party,245,0,245,0.14,Prathipadu ,36,Andhra Pradesh 
590,KOTHAPALLI ARUJANA RAO,Independent,257,0,257,0.15,Prathipadu ,36,Andhra Pradesh 
591,GONTINA SIVARAJA,Independent,872,2,874,0.5,Prathipadu ,36,Andhra Pradesh 
592,NAMMI GANESH,Independent,408,0,408,0.23,Prathipadu ,36,Andhra Pradesh 
593,PILLI BALARAMUDU,Independent,335,3,338,0.19,Prathipadu ,36,Andhra Pradesh 
594,SURLA SRINIVASU,Independent,403,0,403,0.23,Prathipadu ,36,Andhra Pradesh 
595,NOTA,None of the Above,2577,5,2582,1.46,Prathipadu ,36,Andhra Pradesh 
596,BULLI RAJU PRATTIPATI,Bahujan Samaj Party,478,5,483,0.23,Pithapuram ,37,Andhra Pradesh 
597,MADEPALLI SATYANANDA RAO,Indian National Congress,1222,9,1231,0.59,Pithapuram ,37,Andhra Pradesh 
598,VANGA GEETHA VISWANATH,Yuvajana Sramika Rythu Congress Party,63556,559,64115,30.95,Pithapuram ,37,Andhra Pradesh 
599,KONIDALA PAWAN KALYAN,Janasena Party,132725,1669,134394,64.87,Pithapuram ,37,Andhra Pradesh 
600,JAGGARAPU MALLIKHARJUNA,Jaibhim Rao Bharat Party,590,4,594,0.29,Pithapuram ,37,Andhra Pradesh 
601,TAMANNA SIMHADRI,Bharatha Chaitanya Yuvajana Party,247,0,247,0.12,Pithapuram ,37,Andhra Pradesh 
602,PEDDIMSETTI VENKATESWARA RAO,Telugu Janata Party,288,1,289,0.14,Pithapuram ,37,Andhra Pradesh 
603,MADDURI VEERABABU,Pyramid Party of India,285,0,285,0.14,Pithapuram ,37,Andhra Pradesh 
604,EETI JAGADEESH,Independent,1039,0,1039,0.5,Pithapuram ,37,Andhra Pradesh 
605,YEDIDA BHASKARA RAO,Independent,421,2,423,0.2,Pithapuram ,37,Andhra Pradesh 
606,GOWRI MANI BOLISETTI,Independent,1495,0,1495,0.72,Pithapuram ,37,Andhra Pradesh 
607,NAGAM SURIBABU,Independent,265,0,265,0.13,Pithapuram ,37,Andhra Pradesh 
608,SAI SURYA NIKHIL VEGISETTI,Independent,282,0,282,0.14,Pithapuram ,37,Andhra Pradesh 
609,NOTA,None of the Above,2019,8,2027,0.98,Pithapuram ,37,Andhra Pradesh 
610,KURASALA KANNA BABU,Yuvajana Sramika Rythu Congress Party,61263,1111,62374,30.21,Kakinada Rural,38,Andhra Pradesh 
611,PILLI SATYA LAKSHMI,Indian National Congress,2132,73,2205,1.07,Kakinada Rural,38,Andhra Pradesh 
612,SADHANALA RAJU,Bahujan Samaj Party,291,21,312,0.15,Kakinada Rural,38,Andhra Pradesh 
613,KORAMATI MAHARSHI,Telugu Nava Garjana Party,223,0,223,0.11,Kakinada Rural,38,Andhra Pradesh 
614,DADALA BABJI,Jaibhim Rao Bharat Party,310,0,310,0.15,Kakinada Rural,38,Andhra Pradesh 
615,PANTAM VENKATESWARA RAO (PANTAM NANAJI),Janasena Party,131202,3212,134414,65.11,Kakinada Rural,38,Andhra Pradesh 
616,PATNALA VENKATESWARARAO,Jatiya Jana Sena Party,479,1,480,0.23,Kakinada Rural,38,Andhra Pradesh 
617,PALIVELA SWAROOP,Liberation Congress Party,345,2,347,0.17,Kakinada Rural,38,Andhra Pradesh 
618,MELAM VEERASWAMY,Navarang Congress Party,2358,7,2365,1.15,Kakinada Rural,38,Andhra Pradesh 
619,ANNAVARAM PITHANI,Independent,642,33,675,0.33,Kakinada Rural,38,Andhra Pradesh 
620,ANYAM VISWESWARA RAO,Independent,171,1,172,0.08,Kakinada Rural,38,Andhra Pradesh 
621,KARRI GOPALAKRISHNA,Independent,231,3,234,0.11,Kakinada Rural,38,Andhra Pradesh 
622,CHAGANTI SURYANARAYANA MURTHY,Independent,161,0,161,0.08,Kakinada Rural,38,Andhra Pradesh 
623,MADIPALLI RAJU,Independent,148,1,149,0.07,Kakinada Rural,38,Andhra Pradesh 
624,VELUGUBANTLA VEERABHADRARAO,Independent,233,2,235,0.11,Kakinada Rural,38,Andhra Pradesh 
625,NOTA,None of the Above,1744,39,1783,0.86,Kakinada Rural,38,Andhra Pradesh 
626,ARUN KUMAR PEYYALA,Bahujan Samaj Party,726,3,729,0.41,Peddapuram,39,Andhra Pradesh 
627,CHINA RAJAPPA NIMMAKAYALA,Telugu Desam,104407,1278,105685,59.09,Peddapuram,39,Andhra Pradesh 
628,THUMMALA DORABABU,Indian National Congress,2145,23,2168,1.21,Peddapuram,39,Andhra Pradesh 
629,DAVULURI DORABABU,Yuvajana Sramika Rythu Congress Party,64699,535,65234,36.47,Peddapuram,39,Andhra Pradesh 
630,KESAVARAPU RAMA MOHAN RAO,India Praja Bandhu Party,366,1,367,0.21,Peddapuram,39,Andhra Pradesh 
631,BUNGA SATYANARAYANA,Jaibhim Rao Bharat Party,284,0,284,0.16,Peddapuram,39,Andhra Pradesh 
632,GANGAVARAPU LAVANYA,Independent,294,1,295,0.16,Peddapuram,39,Andhra Pradesh 
633,DUVVADA KANNAYYA@KANNABABU,Independent,1225,2,1227,0.69,Peddapuram,39,Andhra Pradesh 
634,MOTUPALLI SIVA KUMAR,Independent,480,0,480,0.27,Peddapuram,39,Andhra Pradesh 
635,RAYUDU MOJESH BABU,Independent,360,0,360,0.2,Peddapuram,39,Andhra Pradesh 
636,NOTA,None of the Above,2009,11,2020,1.13,Peddapuram,39,Andhra Pradesh 
637,KOLLABATHULA SATYANARAYANA (SATYAM),Bahujan Samaj Party,1715,104,1819,1.08,Gannavaram (sc),46,Andhra Pradesh 
638,CHITTIBABU KONDETI,Indian National Congress,1526,57,1583,0.94,Gannavaram (sc),46,Andhra Pradesh 
639,VIPPARTHI . VENUGOPALARAO,Yuvajana Sramika Rythu Congress Party,61913,828,62741,37.3,Gannavaram (sc),46,Andhra Pradesh 
640,KHANDAVALLI SURENDRA.,Pyramid Party of India,720,0,720,0.43,Gannavaram (sc),46,Andhra Pradesh 
641,GIDDI. SATYANARAYANA,Janasena Party,94645,1463,96108,57.14,Gannavaram (sc),46,Andhra Pradesh 
642,DUKKIPATI VIJAYA CHANDRA,Jaibhim Rao Bharat Party,380,0,380,0.23,Gannavaram (sc),46,Andhra Pradesh 
643,NAKKA SEKHAR,Liberation Congress Party,232,1,233,0.14,Gannavaram (sc),46,Andhra Pradesh 
644,BALAKRISHNA KOTA,Jai Bharat National Party,439,3,442,0.26,Gannavaram (sc),46,Andhra Pradesh 
645,SATYANARAYANA GIDDI,Navarang Congress Party,936,3,939,0.56,Gannavaram (sc),46,Andhra Pradesh 
646,SATYANARAYANA. GIDDI,Jatiya Jana Sena Party,318,3,321,0.19,Gannavaram (sc),46,Andhra Pradesh 
647,ANANDARAO KOLLABATHULA,Independent,231,3,234,0.14,Gannavaram (sc),46,Andhra Pradesh 
648,GANNAVARAPU CHANDRA ANAND,Independent,211,2,213,0.13,Gannavaram (sc),46,Andhra Pradesh 
649,NAGABATHULA HEMANTH KUMAR,Independent,419,0,419,0.25,Gannavaram (sc),46,Andhra Pradesh 
650,MAKEY DAVY PRASAD.,Independent,294,5,299,0.18,Gannavaram (sc),46,Andhra Pradesh 
651,NOTA,None of the Above,1744,7,1751,1.04,Gannavaram (sc),46,Andhra Pradesh 
652,ESWARA RAO ROUTHU,Indian National Congress,1146,23,1169,0.54,Kothapeta,47,Andhra Pradesh 
653,KANDRU VENKATESWARA RAO,Bahujan Samaj Party,585,14,599,0.28,Kothapeta,47,Andhra Pradesh 
654,CHIRLA JAGGIREDDY,Yuvajana Sramika Rythu Congress Party,77098,709,77807,35.75,Kothapeta,47,Andhra Pradesh 
655,BANDARU SATYANANDA RAO,Telugu Desam,132951,1335,134286,61.7,Kothapeta,47,Andhra Pradesh 
656,ARUNA KIRAN SATYALA,Jai Bharat National Party,429,1,430,0.2,Kothapeta,47,Andhra Pradesh 
657,DADALA CHANDRA RAO,Liberation Congress Party,130,0,130,0.06,Kothapeta,47,Andhra Pradesh 
658,BANDARU SRINIVASA RAO,Navarang Congress Party,92,0,92,0.04,Kothapeta,47,Andhra Pradesh 
659,BOCHA SRINIVASARAO,Independent,685,6,691,0.32,Kothapeta,47,Andhra Pradesh 
660,MERLA SASTRULU,Independent,69,0,69,0.03,Kothapeta,47,Andhra Pradesh 
661,RAYUDU RAJU,Independent,194,0,194,0.09,Kothapeta,47,Andhra Pradesh 
662,SALADI V.V.D.S.MURTHY,Independent,194,0,194,0.09,Kothapeta,47,Andhra Pradesh 
663,AMBARUKHANA SUDHAKAR,Independent,244,3,247,0.11,Kothapeta,47,Andhra Pradesh 
664,SUNKARA LAKSHMI MANI KUMARI,Independent,145,1,146,0.07,Kothapeta,47,Andhra Pradesh 
665,NOTA,None of the Above,1558,17,1575,0.72,Kothapeta,47,Andhra Pradesh 
666,KAMANA PRABHAKARA RAO,Indian National Congress,1450,34,1484,0.76,Mandapeta,48,Andhra Pradesh 
667,GURRAPU KOTTIYYA,Bahujan Samaj Party,451,2,453,0.23,Mandapeta,48,Andhra Pradesh 
668,JOGESWARA RAO.V,Telugu Desam,115088,1221,116309,59.94,Mandapeta,48,Andhra Pradesh 
669,THOTA TRIMURTHULU,Yuvajana Sramika Rythu Congress Party,71086,788,71874,37.04,Mandapeta,48,Andhra Pradesh 
670,NALLA CHINNA RAO,Liberation Congress Party,293,0,293,0.15,Mandapeta,48,Andhra Pradesh 
671,NANDIKOLLA RAJU,Navataram Party,131,0,131,0.07,Mandapeta,48,Andhra Pradesh 
672,SADEY. DAVID RAJU,Republican Party of India (A),118,2,120,0.06,Mandapeta,48,Andhra Pradesh 
673,KONA SURYA BHASKARA RAO,Independent,103,0,103,0.05,Mandapeta,48,Andhra Pradesh 
674,MANDAPALLI RAVI,Independent,100,1,101,0.05,Mandapeta,48,Andhra Pradesh 
675,RAYUDU SRINIVASU,Independent,138,2,140,0.07,Mandapeta,48,Andhra Pradesh 
676,VEERA VENKATA SATYANARAYANA KONA,Independent,157,0,157,0.08,Mandapeta,48,Andhra Pradesh 
677,SRIKRISHNA KONA,Independent,151,1,152,0.08,Mandapeta,48,Andhra Pradesh 
678,SATYANARAYANA MARNI,Independent,1148,13,1161,0.6,Mandapeta,48,Andhra Pradesh 
679,NOTA,None of the Above,1541,27,1568,0.81,Mandapeta,48,Andhra Pradesh 
680,JAKKAMPUDI RAJA,Yuvajana Sramika Rythu Congress Party,71439,507,71946,37.68,Rajanagaram,49,Andhra Pradesh 
681,MUNDRU VENKATA SRINIVAS(PEDABABU),Indian National Congress,1879,22,1901,1,Rajanagaram,49,Andhra Pradesh 
682,RAVI KUMAR ELLAMILLI,Bahujan Samaj Party,1426,3,1429,0.75,Rajanagaram,49,Andhra Pradesh 
683,KOTHAPALLI BHASKARA RAMAM,Rashtriya Praja Congress (Secular),1707,2,1709,0.9,Rajanagaram,49,Andhra Pradesh 
684,BATHULA BALARAMAKRISHNA S/O GANGARAO,Janasena Party,105113,882,105995,55.51,Rajanagaram,49,Andhra Pradesh 
685,BATHULA BALA RAMA KRISHNA S/O RAMARAO BATHULA,Jatiya Jana Sena Party,842,2,844,0.44,Rajanagaram,49,Andhra Pradesh 
686,BATTULA BALARAMAKRISHNA S/O SRINIVASA RAO BATTULA,Navarang Congress Party,1087,4,1091,0.57,Rajanagaram,49,Andhra Pradesh 
687,MADDA VENKATA RAO (JOSHUA),India Praja Bandhu Party,222,1,223,0.12,Rajanagaram,49,Andhra Pradesh 
688,P. SATYANARAYANA,Jai Bharat National Party,350,0,350,0.18,Rajanagaram,49,Andhra Pradesh 
689,ANAND KUMAR BARRE,Independent,871,3,874,0.46,Rajanagaram,49,Andhra Pradesh 
690,KUSUME GANDHI,Independent,525,1,526,0.28,Rajanagaram,49,Andhra Pradesh 
691,BATHULA VENKATALAKSHMI,Independent,1074,1,1075,0.56,Rajanagaram,49,Andhra Pradesh 
692,NOTA,None of the Above,2968,7,2975,1.56,Rajanagaram,49,Andhra Pradesh 
693,ADIREDDY SRINIVAS,Telugu Desam,121464,1827,123291,67.69,Rajahmundry City,50,Andhra Pradesh 
694,BODA VENKAT,Indian National Congress,1860,58,1918,1.05,Rajahmundry City,50,Andhra Pradesh 
695,MARGANI BHARAT RAM,Yuvajana Sramika Rythu Congress Party,51146,741,51887,28.49,Rajahmundry City,50,Andhra Pradesh 
696,SUREKHA PARAMATA,Bahujan Samaj Party,1084,12,1096,0.6,Rajahmundry City,50,Andhra Pradesh 
697,B.KRISHNA CHAITANYA,Jai Bharat National Party,176,2,178,0.1,Rajahmundry City,50,Andhra Pradesh 
698,MEDA SRINIVASA RAO,Rashtriya Praja Congress (Secular),1524,30,1554,0.85,Rajahmundry City,50,Andhra Pradesh 
699,YANAMADALA MOHAN BABU,Pyramid Party of India,156,0,156,0.09,Rajahmundry City,50,Andhra Pradesh 
700,VEMANA GANESH,Jana Vaahini Party,118,0,118,0.06,Rajahmundry City,50,Andhra Pradesh 
701,"VANGURI VIJAYA SATYA M.A, M.A, B.ED",Liberation Congress Party,198,1,199,0.11,Rajahmundry City,50,Andhra Pradesh 
702,BETHALA VENKATESWARA RAO,Independent,183,2,185,0.1,Rajahmundry City,50,Andhra Pradesh 
703,NOTA,None of the Above,1546,23,1569,0.86,Rajahmundry City,50,Andhra Pradesh 
704,KONDAPALLI SURIBABU,Bahujan Samaj Party,1201,16,1217,0.6,Rajahmundry Rural,51,Andhra Pradesh 
705,GOPALAKRISHNA CHELLUBOYINA(VENU),Yuvajana Sramika Rythu Congress Party,64137,833,64970,32.15,Rajahmundry Rural,51,Andhra Pradesh 
706,GORANTLA BUTCHAIAH CHOUDARY,Telugu Desam,127193,1867,129060,63.87,Rajahmundry Rural,51,Andhra Pradesh 
707,BALEPALLI MURALIDHAR,Indian National Congress,2660,68,2728,1.35,Rajahmundry Rural,51,Andhra Pradesh 
708,DUGGIRALA SRIDEVI,Bharatha Chaitanya Yuvajana Party,356,4,360,0.18,Rajahmundry Rural,51,Andhra Pradesh 
709,MANNAVA RAGHURAM,Jai Bharat National Party,308,2,310,0.15,Rajahmundry Rural,51,Andhra Pradesh 
710,CHINTALAPATI PAVAN KUMAR,Independent,714,0,714,0.35,Rajahmundry Rural,51,Andhra Pradesh 
711,NOTA,None of the Above,2650,49,2699,1.34,Rajahmundry Rural,51,Andhra Pradesh 
712,JUTHUKA NAGESWARA RAO,Bahujan Samaj Party,690,6,696,0.36,Jaggampeta,52,Andhra Pradesh 
713,JYOTHULA NEHRU,Telugu Desam,112591,1002,113593,58.56,Jaggampeta,52,Andhra Pradesh 
714,THOTA NARASIMHAM,Yuvajana Sramika Rythu Congress Party,60496,421,60917,31.4,Jaggampeta,52,Andhra Pradesh 
715,MAROTHI SIVA GANESH,Indian National Congress,1448,9,1457,0.75,Jaggampeta,52,Andhra Pradesh 
716,KOTHAPALLI SURIBABU,Republican Party of India (Khobragade),261,1,262,0.14,Jaggampeta,52,Andhra Pradesh 
717,CHITTURI NAGA LAKSHMI,Pyramid Party of India,86,0,86,0.04,Jaggampeta,52,Andhra Pradesh 
718,VALLURI SATYANANDAM,Jaibhim Rao Bharat Party,251,0,251,0.13,Jaggampeta,52,Andhra Pradesh 
719,SADHE NARENDRABABU,Liberation Congress Party,473,1,474,0.24,Jaggampeta,52,Andhra Pradesh 
720,KALDARI RANI,Independent,594,1,595,0.31,Jaggampeta,52,Andhra Pradesh 
721,DOMMETI KUSALANNA,Independent,275,0,275,0.14,Jaggampeta,52,Andhra Pradesh 
722,PATAMSETTI SURYACHANDRA,Independent,12467,64,12531,6.46,Jaggampeta,52,Andhra Pradesh 
723,BALIREDDY SOLOMON RAJU,Independent,286,1,287,0.15,Jaggampeta,52,Andhra Pradesh 
724,BODDETI APPARAO,Independent,297,1,298,0.15,Jaggampeta,52,Andhra Pradesh 
725,DR. SANKUMALLA APPARAO,Independent,329,0,329,0.17,Jaggampeta,52,Andhra Pradesh 
726,NOTA,None of the Above,1913,15,1928,0.99,Jaggampeta,52,Andhra Pradesh 
727,KAKURU KANNAM REDDY,Bahujan Samaj Party,2186,5,2191,1.04,Rampachodavaram,53,Andhra Pradesh 
728,NAGULAPALLI DHANALAKSHMI,Yuvajana Sramika Rythu Congress Party,80130,818,80948,38.45,Rampachodavaram,53,Andhra Pradesh 
729,MIRIYALA SIRISHA DEVI,Telugu Desam,88254,1833,90087,42.8,Rampachodavaram,53,Andhra Pradesh 
730,LOTHA RAMARAO,Communist Party of India (Marxist),19971,1294,21265,10.1,Rampachodavaram,53,Andhra Pradesh 
731,DUMANTHU VISWANADHAM,Republican Party of India,647,4,651,0.31,Rampachodavaram,53,Andhra Pradesh 
732,MADDITI ANJI REDDY,Bharat Adivasi Party,746,8,754,0.36,Rampachodavaram,53,Andhra Pradesh 
733,MANUPUDI SUBBA RAO,Pyramid Party of India,631,0,631,0.3,Rampachodavaram,53,Andhra Pradesh 
734,KUNJA SRINU,Independent,716,33,749,0.36,Rampachodavaram,53,Andhra Pradesh 
735,PALLALA LATCHI REDDY,Independent,3026,35,3061,1.45,Rampachodavaram,53,Andhra Pradesh 
736,PALADUGU LAKSHMI PRASANNA,Independent,798,2,800,0.38,Rampachodavaram,53,Andhra Pradesh 
737,PALADUGU SRI VENKATESWARA RAO,Independent,878,0,878,0.42,Rampachodavaram,53,Andhra Pradesh 
738,BANGARU VENKATESH,Independent,1215,9,1224,0.58,Rampachodavaram,53,Andhra Pradesh 
739,NOTA,None of the Above,7249,20,7269,3.45,Rampachodavaram,53,Andhra Pradesh 
740,ARIGELA ARUNA KUMARI,Indian National Congress,1863,34,1897,1.19,Kovvu,54,Andhra Pradesh 
741,TALARI VENKATA RAO,Yuvajana Sramika Rythu Congress Party,58254,543,58797,36.95,Kovvu,54,Andhra Pradesh 
742,MUPPIDI VENKATESWARA RAO,Telugu Desam,91720,1023,92743,58.29,Kovvu,54,Andhra Pradesh 
743,BONTA SYAM RAVI PRAKASH,Liberation Congress Party,649,3,652,0.41,Kovvu,54,Andhra Pradesh 
744,MUPPIDI SEKHAR BABU,Navarang Congress Party,192,2,194,0.12,Kovvu,54,Andhra Pradesh 
745,SEKHAR BABU KOYYA,Rashtriya Praja Congress (Secular),1247,8,1255,0.79,Kovvu,54,Andhra Pradesh 
746,UBA SRIKANTH,Independent,369,0,369,0.23,Kovvu,54,Andhra Pradesh 
747,KAMALA ARUGOLANU,Independent,151,1,152,0.1,Kovvu,54,Andhra Pradesh 
748,KOKKIRIPATI CHINABABU,Independent,162,1,163,0.1,Kovvu,54,Andhra Pradesh 
749,TATAPUDI PRAVEEN,Independent,166,0,166,0.1,Kovvu,54,Andhra Pradesh 
750,BONTHA KISHORE,Independent,254,4,258,0.16,Kovvu,54,Andhra Pradesh 
751,NOTA,None of the Above,2444,21,2465,1.55,Kovvu,54,Andhra Pradesh 
752,GUMMAPU. CHITRASENU,Bahujan Samaj Party,1209,51,1260,0.69,Nidadavole,55,Andhra Pradesh 
753,PEDDIREDDI SUBBARAO,Indian National Congress,1471,24,1495,0.82,Nidadavole,55,Andhra Pradesh 
754,G.SRINIVAS NAIDU,Yuvajana Sramika Rythu Congress Party,68800,595,69395,38.02,Nidadavole,55,Andhra Pradesh 
755,KASTURI SATYA PRASAD,All India Forward Bloc,1680,11,1691,0.93,Nidadavole,55,Andhra Pradesh 
756,KOTTIYADA DURGA,Jatiya Jana Sena Party,450,4,454,0.25,Nidadavole,55,Andhra Pradesh 
757,KANCHERLA DURGESH,Navarang Congress Party,1652,16,1668,0.91,Nidadavole,55,Andhra Pradesh 
758,KANDULA DURGESH,Janasena Party,101609,1090,102699,56.27,Nidadavole,55,Andhra Pradesh 
759,PULAMALA VEERA BHADRAM,Jai Bharat National Party,310,1,311,0.17,Nidadavole,55,Andhra Pradesh 
760,MUKKAMALA ANNAVARA PRASAD. (PYRAMID PRASAD),Pyramid Party of India,277,1,278,0.15,Nidadavole,55,Andhra Pradesh 
761,ARIGELA SATYA VARA PRASAD,Independent,477,1,478,0.26,Nidadavole,55,Andhra Pradesh 
762,VENKATESWARA NAIDU GIDDA,Independent,347,0,347,0.19,Nidadavole,55,Andhra Pradesh 
763,SRINIVASA NAIDU GIDDA,Independent,282,1,283,0.16,Nidadavole,55,Andhra Pradesh 
764,NOTA,None of the Above,2137,7,2144,1.17,Nidadavole,55,Andhra Pradesh 
765,ARJUNARAO KOLUKULURI,Indian National Congress,1913,32,1945,1.19,Palacole,57,Andhra Pradesh 
766,ELIYA KOLLABATHULA,Bahujan Samaj Party,461,12,473,0.29,Palacole,57,Andhra Pradesh 
767,GUDALA SRI HARI GOPALA RAO (GUDALA GOPI),Yuvajana Sramika Rythu Congress Party,44590,579,45169,27.67,Palacole,57,Andhra Pradesh 
768,DR.NIMMALA RAMANAIDU,Telugu Desam,111471,1643,113114,69.3,Palacole,57,Andhra Pradesh 
769,POLISETTI SIVA KRISHNA,Pyramid Party of India,271,1,272,0.17,Palacole,57,Andhra Pradesh 
770,BEZAWADA TULASIRAO,Jai Bharat National Party,116,4,120,0.07,Palacole,57,Andhra Pradesh 
771,ANANTHA NAGA BHUSHANAM TAMMA,Independent,63,1,64,0.04,Palacole,57,Andhra Pradesh 
772,KOTIKALAPUDI PRADEEP,Independent,64,0,64,0.04,Palacole,57,Andhra Pradesh 
773,JALLA VASU,Independent,68,0,68,0.04,Palacole,57,Andhra Pradesh 
774,TANETI CHINNABBULU,Independent,45,0,45,0.03,Palacole,57,Andhra Pradesh 
775,TANETI PRASAD,Independent,66,0,66,0.04,Palacole,57,Andhra Pradesh 
776,NALLI RAJESH,Independent,74,1,75,0.05,Palacole,57,Andhra Pradesh 
777,PALAPARTHI JOHN SON,Independent,421,1,422,0.26,Palacole,57,Andhra Pradesh 
778,VASANTHALA D.V. SURESH,Independent,137,0,137,0.08,Palacole,57,Andhra Pradesh 
779,SALADI SRI RAMA MURTHY,Independent,259,1,260,0.16,Palacole,57,Andhra Pradesh 
780,NOTA,None of the Above,900,19,919,0.56,Palacole,57,Andhra Pradesh 
781,KANURI UDAYA BHASKARA KRISHNA PRASAD,Indian National Congress,1883,32,1915,1.32,Narasapuram,58,Andhra Pradesh 
782,BANDELA RAJENDRA PRASAD,Bahujan Samaj Party,413,7,420,0.29,Narasapuram,58,Andhra Pradesh 
783,NAGARAJA VARA PRASADA RAJU MUDUNURI,Yuvajana Sramika Rythu Congress Party,43945,433,44378,30.52,Narasapuram,58,Andhra Pradesh 
784,AKULA VENKATA SWAMY,Bharatha Chaitanya Yuvajana Party,539,1,540,0.37,Narasapuram,58,Andhra Pradesh 
785,KOLLI SATYA NAYAKAR,Navarang Congress Party,1169,3,1172,0.81,Narasapuram,58,Andhra Pradesh 
786,PALEPU SATYA LINGA NAYAKAR,Jatiya Jana Sena Party,339,4,343,0.24,Narasapuram,58,Andhra Pradesh 
787,POTHURAJU YACOBU,Jaibhim Rao Bharat Party,372,0,372,0.26,Narasapuram,58,Andhra Pradesh 
788,BURRA RAMAKRISHNA,Pyramid Party of India,425,0,425,0.29,Narasapuram,58,Andhra Pradesh 
789,BOMMIDI NARAYANA NAYAKAR,Janasena Party,93041,1075,94116,64.72,Narasapuram,58,Andhra Pradesh 
790,KANCHANA VENKATA RAMESH,Independent,295,0,295,0.2,Narasapuram,58,Andhra Pradesh 
791,GADI RAVI,Independent,226,0,226,0.16,Narasapuram,58,Andhra Pradesh 
792,NOTA,None of the Above,1208,8,1216,0.84,Narasapuram,58,Andhra Pradesh 
793,ANKEM SEETARAM,Indian National Congress,3205,47,3252,1.59,Bhimavaram ,59,Andhra Pradesh 
794,GRANDHI SRINIVAS,Yuvajana Sramika Rythu Congress Party,62662,788,63450,31.11,Bhimavaram ,59,Andhra Pradesh 
795,BUGGE RACHERLA,Bahujan Samaj Party,1037,0,1037,0.51,Bhimavaram ,59,Andhra Pradesh 
796,ALLURI SRINIVASA RAJU,Pyramid Party of India,269,1,270,0.13,Bhimavaram ,59,Andhra Pradesh 
797,KADIEM RAMANJANEYULU,Jatiya Jana Sena Party,631,5,636,0.31,Bhimavaram ,59,Andhra Pradesh 
798,DANDU . SRINIVASA RAJU,All India Forward Bloc,219,2,221,0.11,Bhimavaram ,59,Andhra Pradesh 
799,PEPETI VADDI KASULU,Bharatha Chaitanya Yuvajana Party,272,0,272,0.13,Bhimavaram ,59,Andhra Pradesh 
800,PERICHERLA RAMANJANEYULU,Navarang Congress Party,1503,0,1503,0.74,Bhimavaram ,59,Andhra Pradesh 
801,BASWANI PAVAN KUMAR,Jaibhim Rao Bharat Party,574,1,575,0.28,Bhimavaram ,59,Andhra Pradesh 
802,RAMANJANEYULU PULAPARTHI (ANJIBABU),Janasena Party,128701,1723,130424,63.94,Bhimavaram ,59,Andhra Pradesh 
803,YEDUKONDALU,Independent,388,0,388,0.19,Bhimavaram ,59,Andhra Pradesh 
804,GUGGILAPU RAMAKRISHNA,Independent,143,0,143,0.07,Bhimavaram ,59,Andhra Pradesh 
805,CHAMAKURI KUSUMA KUMARI PADMAVATHI,Independent,131,0,131,0.06,Bhimavaram ,59,Andhra Pradesh 
806,MANDAVA. NAGESWARA RAO,Independent,240,0,240,0.12,Bhimavaram ,59,Andhra Pradesh 
807,MEHAR MANOHAR PENTAPATI,Independent,231,0,231,0.11,Bhimavaram ,59,Andhra Pradesh 
808,NOTA,None of the Above,1199,11,1210,0.59,Bhimavaram ,59,Andhra Pradesh 
809,KANUMURU RAGHU RAMA KRISHNA RAJU (R R R),Telugu Desam,115942,960,116902,59.8,Undi,60,Andhra Pradesh 
810,PENMETSA VENKATA LAKSHMI NARASIMHA RAJU (P.V.L),Yuvajana Sramika Rythu Congress Party,59521,604,60125,30.76,Undi,60,Andhra Pradesh 
811,MALLIPUDI SHARMILA,Bahujan Samaj Party,1137,3,1140,0.58,Undi,60,Andhra Pradesh 
812,VENKATA GOPALA KRISHNAM RAJU VEGESNA,Indian National Congress,1142,15,1157,0.59,Undi,60,Andhra Pradesh 
813,ALLURI SATISH CHANDRA KUMAR,Pyramid Party of India,112,2,114,0.06,Undi,60,Andhra Pradesh 
814,KADIYAM SURIBABU,Nationalist Janshakti Party,95,0,95,0.05,Undi,60,Andhra Pradesh 
815,RAVI VARMA MUDUNDI,Akhil Bharatiya Jan Sangh,111,0,111,0.06,Undi,60,Andhra Pradesh 
816,SIVA RAMA RAJU .P,Neethi Nijayithi Party,169,0,169,0.09,Undi,60,Andhra Pradesh 
817,V V SIVA RAMA RAJU (KALAVAPUDI SIVA),All India Forward Bloc,13107,153,13260,6.78,Undi,60,Andhra Pradesh 
818,KUNAPARAJU VENKATA KRISHNAM RAJU,Independent,109,0,109,0.06,Undi,60,Andhra Pradesh 
819,PREMAKUMAR DIDLA (YENDAGANDI PREMJI),Independent,117,0,117,0.06,Undi,60,Andhra Pradesh 
820,SIVA GAJULA (KOLAMURU SIVA),Independent,185,0,185,0.09,Undi,60,Andhra Pradesh 
821,SATEESH RAJU DANDU,Independent,381,0,381,0.19,Undi,60,Andhra Pradesh 
822,NOTA,None of the Above,1597,10,1607,0.82,Undi,60,Andhra Pradesh 
823,AKUMARTHI DHANUMJAYA,Bahujan Samaj Party,1407,20,1427,0.73,Tanuku,61,Andhra Pradesh 
824,ARIMILLI RADHA KRISHNA,Telugu Desam,127954,1593,129547,66.51,Tanuku,61,Andhra Pradesh 
825,KADALI RAMA RAO,Indian National Congress,2402,20,2422,1.24,Tanuku,61,Andhra Pradesh 
826,KARUMURI VENKATA NAGESWARA RAO,Yuvajana Sramika Rythu Congress Party,56895,531,57426,29.48,Tanuku,61,Andhra Pradesh 
827,SAAKA SURESH,Jaibhim Rao Bharat Party,378,0,378,0.19,Tanuku,61,Andhra Pradesh 
828,KARUTURI SUBBARAO,Independent,889,12,901,0.46,Tanuku,61,Andhra Pradesh 
829,KUMARI PUPPALA,Independent,90,0,90,0.05,Tanuku,61,Andhra Pradesh 
830,KODURI MEHAR CHAITANYA,Independent,161,1,162,0.08,Tanuku,61,Andhra Pradesh 
831,CHITTURI SATYANARAYANA,Independent,59,1,60,0.03,Tanuku,61,Andhra Pradesh 
832,MAMIDISETTI MOHAN AAJI,Independent,93,2,95,0.05,Tanuku,61,Andhra Pradesh 
833,MURALI KRISHNA SAJJA,Independent,172,1,173,0.09,Tanuku,61,Andhra Pradesh 
834,RAPETI RAMANA BABU,Independent,149,0,149,0.08,Tanuku,61,Andhra Pradesh 
835,RAMACHANDRA RAO KUSAMPUDI,Independent,216,0,216,0.11,Tanuku,61,Andhra Pradesh 
836,NOTA,None of the Above,1699,23,1722,0.88,Tanuku,61,Andhra Pradesh 
837,KOTTU SATYANARAYANA,Yuvajana Sramika Rythu Congress Party,53445,506,53951,30.3,Tadepalligudem,62,Andhra Pradesh 
838,MARNEEDI. SEKHAR (BABJI),Indian National Congress,1868,33,1901,1.07,Tadepalligudem,62,Andhra Pradesh 
839,P.S.R. KRISHNA,Jai Bharat National Party,913,6,919,0.52,Tadepalligudem,62,Andhra Pradesh 
840,BUSANABOIYINA ANJANEYULU.,Jatiya Jana Sena Party,502,4,506,0.28,Tadepalligudem,62,Andhra Pradesh 
841,BOLISETTY SRINIVAS,Janasena Party,114955,1488,116443,65.4,Tadepalligudem,62,Andhra Pradesh 
842,BOLISETTY SRINUVASA RAO,Navarang Congress Party,749,3,752,0.42,Tadepalligudem,62,Andhra Pradesh 
843,MARAPATLA. RAJU,Republican Party of India (A),739,1,740,0.42,Tadepalligudem,62,Andhra Pradesh 
844,MEKA VENKATESWARA RAO,Pyramid Party of India,201,2,203,0.11,Tadepalligudem,62,Andhra Pradesh 
845,UNGARALA PADMA,Independent,253,1,254,0.14,Tadepalligudem,62,Andhra Pradesh 
846,NADAPANA ACHYUTA KUMAR,Independent,157,0,157,0.09,Tadepalligudem,62,Andhra Pradesh 
847,B. RAJESH,Independent,263,0,263,0.15,Tadepalligudem,62,Andhra Pradesh 
848,LANKA PRASAD,Independent,183,5,188,0.11,Tadepalligudem,62,Andhra Pradesh 
849,SIRIVARAPU SIMHACHALAM,Independent,238,0,238,0.13,Tadepalligudem,62,Andhra Pradesh 
850,NOTA,None of the Above,1522,12,1534,0.86,Tadepalligudem,62,Andhra Pradesh 
851,PATHAPATI HARI KUMARA RAJU,Indian National Congress,3100,30,3130,1.71,Ungutur ,63,Andhra Pradesh 
852,PUPPALA SRINIVASA RAO (VASU BABU),Yuvajana Sramika Rythu Congress Party,63472,477,63949,35.02,Ungutur ,63,Andhra Pradesh 
853,BUNGA YESU,Bahujan Samaj Party,1297,5,1302,0.71,Ungutur ,63,Andhra Pradesh 
854,DHARMARAJU PATSAMATLA,Janasena Party,107915,979,108894,59.63,Ungutur ,63,Andhra Pradesh 
855,PEDAPUDI DHARMARAJU,Jatiya Jana Sena Party,638,5,643,0.35,Ungutur ,63,Andhra Pradesh 
856,PERUMALLA MURALI KRISHNA,Pyramid Party of India,224,0,224,0.12,Ungutur ,63,Andhra Pradesh 
857,POTLA DHARMARAJU,Navarang Congress Party,1066,4,1070,0.59,Ungutur ,63,Andhra Pradesh 
858,ASEERWADAM NEKURI,Independent,223,0,223,0.12,Ungutur ,63,Andhra Pradesh 
859,NALLAMELLI SHANKARA RAO,Independent,299,1,300,0.16,Ungutur ,63,Andhra Pradesh 
860,PUTTA KUMAR,Independent,237,0,237,0.13,Ungutur ,63,Andhra Pradesh 
861,PUPPALA SRINIVASA RAO (VASU BABU),Independent,256,1,257,0.14,Ungutur ,63,Andhra Pradesh 
862,BATHU NAGESWARA RAO (NAGARAJU),Independent,287,2,289,0.16,Ungutur ,63,Andhra Pradesh 
863,NOTA,None of the Above,2093,12,2105,1.15,Ungutur ,63,Andhra Pradesh 
864,ABBAYA CHOWDARY KOTHARU,Yuvajana Sramika Rythu Congress Party,80252,769,81021,41.62,Denduluru,64,Andhra Pradesh 
865,ALAPATI NARASIMHA MURTHY,Indian National Congress,1594,13,1607,0.83,Denduluru,64,Andhra Pradesh 
866,CHINTAMANENI PRABHAKAR,Telugu Desam,106327,960,107287,55.11,Denduluru,64,Andhra Pradesh 
867,NETALA RAMESH BABU,Bahujan Samaj Party,1598,4,1602,0.82,Denduluru,64,Andhra Pradesh 
868,CHILUKURI PRABHAKAR RAO,Jatiya Jana Sena Party,141,2,143,0.07,Denduluru,64,Andhra Pradesh 
869,PRASAD AMUDALAPALLI,Pyramid Party of India,67,1,68,0.03,Denduluru,64,Andhra Pradesh 
870,ASHOK CHOWDARY,Independent,74,0,74,0.04,Denduluru,64,Andhra Pradesh 
871,ALAGA RAVI KUMAR,Independent,67,2,69,0.04,Denduluru,64,Andhra Pradesh 
872,KONAKALLA SRINIVASA RAO,Independent,40,0,40,0.02,Denduluru,64,Andhra Pradesh 
873,CHERUKURI SRI RAM KUMAR,Independent,124,2,126,0.06,Denduluru,64,Andhra Pradesh 
874,NAGA RAM PRASAD PERISETTI,Independent,70,0,70,0.04,Denduluru,64,Andhra Pradesh 
875,NUTI NAGARAJU,Independent,75,0,75,0.04,Denduluru,64,Andhra Pradesh 
876,NUTHI RAVINDRA,Independent,142,1,143,0.07,Denduluru,64,Andhra Pradesh 
877,PACHIGOLLA JOHN DHARMA RAJU,Independent,167,0,167,0.09,Denduluru,64,Andhra Pradesh 
878,PALLI RAMESH,Independent,253,1,254,0.13,Denduluru,64,Andhra Pradesh 
879,NOTA,None of the Above,1910,10,1920,0.99,Denduluru,64,Andhra Pradesh 
880,ALLA KALI KRISHNA SRINIVAS,Yuvajana Sramika Rythu Congress Party,48098,1076,49174,29.57,Eluru,65,Andhra Pradesh 
881,RATHAN KANTH ANDUGALA,Bahujan Samaj Party,532,20,552,0.33,Eluru,65,Andhra Pradesh 
882,RADHA KRISHNAYYA BADETI,Telugu Desam,109359,2203,111562,67.09,Eluru,65,Andhra Pradesh 
883,ALLURI SATYANARAYANA RAJU,Pyramid Party of India,611,2,613,0.37,Eluru,65,Andhra Pradesh 
884,JOSHILA MULAGALA,Jai Bharat National Party,96,3,99,0.06,Eluru,65,Andhra Pradesh 
885,BANDI VENKATESWARA RAO,Communist Party of India,578,26,604,0.36,Eluru,65,Andhra Pradesh 
886,MATHE BOBBY,Republican Party of India (A),1750,20,1770,1.06,Eluru,65,Andhra Pradesh 
887,SHAIK HUSSAIN,Reforms Party of India,63,3,66,0.04,Eluru,65,Andhra Pradesh 
888,JILLELLAMUDI NAGA UMAMAHESWARA RAO,Independent,127,3,130,0.08,Eluru,65,Andhra Pradesh 
889,NALLAMELLI PRASANNA KUMAR,Independent,48,0,48,0.03,Eluru,65,Andhra Pradesh 
890,M.M.NAIDU,Independent,81,0,81,0.05,Eluru,65,Andhra Pradesh 
891,PITTA DHANUNJAY KUMAR,Independent,62,0,62,0.04,Eluru,65,Andhra Pradesh 
892,POLISETTI TULASIRAM,Independent,95,0,95,0.06,Eluru,65,Andhra Pradesh 
893,RAJANALA SRINVASA RAO,Independent,160,3,163,0.1,Eluru,65,Andhra Pradesh 
894,NOTA,None of the Above,1212,44,1256,0.76,Eluru,65,Andhra Pradesh 
895,TANETI VANITA,Yuvajana Sramika Rythu Congress Party,87149,487,87636,41.4,Gopalapuram,66,Andhra Pradesh 
896,BHARATHA RAO SIRRA (BHARATH),Bahujan Samaj Party,1023,12,1035,0.49,Gopalapuram,66,Andhra Pradesh 
897,MADDIPATI VENKATA RAJU,Telugu Desam,113676,744,114420,54.06,Gopalapuram,66,Andhra Pradesh 
898,SODADASI MARTIN LUTHER,Indian National Congress,2373,14,2387,1.13,Gopalapuram,66,Andhra Pradesh 
899,PENUMAKA VENKATA RATNAM,Jatiya Jana Sena Party,342,0,342,0.16,Gopalapuram,66,Andhra Pradesh 
900,BATHULA VENU,All India Forward Bloc,206,0,206,0.1,Gopalapuram,66,Andhra Pradesh 
901,SRINIVASA RAO MULAGALA,Jai Bharat National Party,166,0,166,0.08,Gopalapuram,66,Andhra Pradesh 
902,DODDIGARLA . NAGARJUNA,Independent,168,0,168,0.08,Gopalapuram,66,Andhra Pradesh 
903,MUKKAVALLI VENKATA RAMANA,Independent,271,0,271,0.13,Gopalapuram,66,Andhra Pradesh 
904,RAPAKA HAREESH KUMAR,Independent,528,0,528,0.25,Gopalapuram,66,Andhra Pradesh 
905,NOTA,None of the Above,4488,12,4500,2.13,Gopalapuram,66,Andhra Pradesh 
906,TELLAM RAJYA LAKSHMI,Yuvajana Sramika Rythu Congress Party,92581,937,93518,42.7,Polavaram,67,Andhra Pradesh 
907,MADAKAM VENKATESWARA RAO,Bahujan Samaj Party,1865,10,1875,0.86,Polavaram,67,Andhra Pradesh 
908,SRUJANA DUVVELA,Indian National Congress,3522,46,3568,1.63,Polavaram,67,Andhra Pradesh 
909,UKE MANGAMMA,Yuva Taram Party,915,1,916,0.42,Polavaram,67,Andhra Pradesh 
910,CHIRRI BALARAJU,Janasena Party,99937,1516,101453,46.33,Polavaram,67,Andhra Pradesh 
911,MADAKAM VENKATESWARARAO,Gondwana Dandkaranya Party,906,12,918,0.42,Polavaram,67,Andhra Pradesh 
912,MODIYAM SRINIVASARAO,Bharat Adivasi Party,508,69,577,0.26,Polavaram,67,Andhra Pradesh 
913,KAKA KRISHNA,Independent,3693,15,3708,1.69,Polavaram,67,Andhra Pradesh 
914,BADISA BOJJI DORA,Independent,482,13,495,0.23,Polavaram,67,Andhra Pradesh 
915,MODIYAM SURYA CHANDRA RAO,Independent,1966,73,2039,0.93,Polavaram,67,Andhra Pradesh 
916,SARIYAM RAM MOHAN,Independent,3801,10,3811,1.74,Polavaram,67,Andhra Pradesh 
917,SARIYAM SURAMMA,Independent,507,3,510,0.23,Polavaram,67,Andhra Pradesh 
918,NOTA,None of the Above,5583,28,5611,2.56,Polavaram,67,Andhra Pradesh 
919,VUNNAMATLA RAKADA ELIZA,Indian National Congress,4902,56,4958,2.2,Chintalapudi,68,Andhra Pradesh 
920,KAMBHAM VIJAYA RAJU,Yuvajana Sramika Rythu Congress Party,91549,811,92360,40.98,Chintalapudi,68,Andhra Pradesh 
921,ROSHAN KUMAR SONGA,Telugu Desam,118521,1605,120126,53.3,Chintalapudi,68,Andhra Pradesh 
922,VENKATA CHAITANYA LAKKAPAMU,Bahujan Samaj Party,1070,6,1076,0.48,Chintalapudi,68,Andhra Pradesh 
923,ESTHER RANI MUVVALA,Independent,2059,18,2077,0.92,Chintalapudi,68,Andhra Pradesh 
924,KALAPALA PRASAD,Independent,188,1,189,0.08,Chintalapudi,68,Andhra Pradesh 
925,TORLAPATI SRINIVASARAO,Independent,164,4,168,0.07,Chintalapudi,68,Andhra Pradesh 
926,PACHIGOLLA JOHN DHARMA RAJU,Independent,315,1,316,0.14,Chintalapudi,68,Andhra Pradesh 
927,NOTA,None of the Above,4103,18,4121,1.83,Chintalapudi,68,Andhra Pradesh 
928,KOLIKAPUDI SRINIVASA RAO,Telugu Desam,99157,1562,100719,54.91,Tiruvuru,69,Andhra Pradesh 
929,NALLAGATLA SWAMY DAS,Yuvajana Sramika Rythu Congress Party,77873,972,78845,42.99,Tiruvuru,69,Andhra Pradesh 
930,LAKKEPOGU VANDANA KUMAR,Bahujan Samaj Party,600,24,624,0.34,Tiruvuru,69,Andhra Pradesh 
931,LAM THANTIYA KUMARI,Indian National Congress,1306,23,1329,0.72,Tiruvuru,69,Andhra Pradesh 
932,CHILAPARAPU VENKATESWARA RAO,Bharatha Chaitanya Yuvajana Party,97,2,99,0.05,Tiruvuru,69,Andhra Pradesh 
933,BOLLIPOGU NAGARAJU,Jana Vaahini Party,44,1,45,0.02,Tiruvuru,69,Andhra Pradesh 
934,SEELAM RAJA,Liberation Congress Party,40,0,40,0.02,Tiruvuru,69,Andhra Pradesh 
935,KURAPATI KRISHNAIAH,Independent,47,0,47,0.03,Tiruvuru,69,Andhra Pradesh 
936,KORLAPATI RAVEENDRABABU,Independent,85,0,85,0.05,Tiruvuru,69,Andhra Pradesh 
937,KOLIKAPOGU VENKATA RAO,Independent,90,0,90,0.05,Tiruvuru,69,Andhra Pradesh 
938,BIMALA ANUSHA,Independent,114,0,114,0.06,Tiruvuru,69,Andhra Pradesh 
939,MEHAR BABA VASAM,Independent,199,0,199,0.11,Tiruvuru,69,Andhra Pradesh 
940,NOTA,None of the Above,1174,10,1184,0.65,Tiruvuru,69,Andhra Pradesh 
941,KOLUSU PARTHA SARATHY,Telugu Desam,107303,926,108229,51.12,Nuzvid,70,Andhra Pradesh 
942,CHALIGANTI VENKATESH (DOCTOR),Bahujan Samaj Party,1286,5,1291,0.61,Nuzvid,70,Andhra Pradesh 
943,MAREEDU. KRISHNA,Indian National Congress,2389,16,2405,1.14,Nuzvid,70,Andhra Pradesh 
944,MEKA VENKATA PRATAP APPARAO,Yuvajana Sramika Rythu Congress Party,95082,769,95851,45.27,Nuzvid,70,Andhra Pradesh 
945,PAMU. RAVEENDRA NADH,Reforms Party of India,437,1,438,0.21,Nuzvid,70,Andhra Pradesh 
946,SOMU VENKATA SIVA PURNA CHANDRARAO (SIVA),Jatiya Jana Sena Party,178,0,178,0.08,Nuzvid,70,Andhra Pradesh 
947,AMUDALA ISSAKU @ PITCHAIAH,Independent,98,0,98,0.05,Nuzvid,70,Andhra Pradesh 
948,KOLUSU KAMALA LAKSHMI,Independent,115,0,115,0.05,Nuzvid,70,Andhra Pradesh 
949,BOTLA. SIVA SATYANARAYANA.,Independent,115,0,115,0.05,Nuzvid,70,Andhra Pradesh 
950,MANDALAPU SRINIVASARAO,Independent,226,0,226,0.11,Nuzvid,70,Andhra Pradesh 
951,NOTA,None of the Above,2757,14,2771,1.31,Nuzvid,70,Andhra Pradesh 
952,KALLAM VENKATESWARARAO,Communist Party of India (Marxist),1186,33,1219,0.51,Gannavaram,71,Andhra Pradesh 
953,YARLAGADDA VENKATA RAO,Telugu Desam,134093,1459,135552,56.59,Gannavaram,71,Andhra Pradesh 
954,VAMSI VALLABHANENI,Yuvajana Sramika Rythu Congress Party,96962,962,97924,40.88,Gannavaram,71,Andhra Pradesh 
955,TADANKI JAGDISH RAMACHANDRARAO,Telugu Rajadhikara Samiti Party,703,1,704,0.29,Gannavaram,71,Andhra Pradesh 
956,DONDAPATI ANAND PRASAD,All India Forward Bloc,256,0,256,0.11,Gannavaram,71,Andhra Pradesh 
957,POTLURI RAVINDRA KUMAR,Republican Party of India (Athawale),602,0,602,0.25,Gannavaram,71,Andhra Pradesh 
958,ARUNA KUMARI PRATHIPATI,Independent,145,2,147,0.06,Gannavaram,71,Andhra Pradesh 
959,KORRAPOLU SRINIVASA RAO,Independent,349,0,349,0.15,Gannavaram,71,Andhra Pradesh 
960,GUNTUPALLY UMAMAHESWARARAO,Independent,103,4,107,0.04,Gannavaram,71,Andhra Pradesh 
961,POTLURI SREEDEVI,Independent,95,0,95,0.04,Gannavaram,71,Andhra Pradesh 
962,VALLABHANENI MOHAN VAMSI K,Independent,634,2,636,0.27,Gannavaram,71,Andhra Pradesh 
963,SARNALA VIJAYADURGA,Independent,203,0,203,0.08,Gannavaram,71,Andhra Pradesh 
964,NOTA,None of the Above,1713,18,1731,0.72,Gannavaram,71,Andhra Pradesh 
965,KODALI SRI VENKATESWARA RAO (NANI),Yuvajana Sramika Rythu Congress Party,55975,965,56940,33.18,Gudivada,72,Andhra Pradesh 
966,BOSU BABU GUDIVADA,Bahujan Samaj Party,479,16,495,0.29,Gudivada,72,Andhra Pradesh 
967,VADDADI GOVINDA RAO (RAJESH),Indian National Congress,1320,13,1333,0.78,Gudivada,72,Andhra Pradesh 
968,VENIGANDLA RAMU,Telugu Desam,107975,2005,109980,64.09,Gudivada,72,Andhra Pradesh 
969,ALLURI HEMANTH KUMAR,Jai Bharat National Party,388,1,389,0.23,Gudivada,72,Andhra Pradesh 
970,AVULA PRAVEEN KUMAR,Telugu Rajadhikara Samiti Party,680,3,683,0.4,Gudivada,72,Andhra Pradesh 
971,NALLAGANCHU VENKATA RAMBABU,Jatiya Jana Sena Party,203,1,204,0.12,Gudivada,72,Andhra Pradesh 
972,KUMMARI BHAVANNARAYANA,Independent,94,1,95,0.06,Gudivada,72,Andhra Pradesh 
973,GUNDABATHINA AMBEDKAR (RAJA),Independent,100,0,100,0.06,Gudivada,72,Andhra Pradesh 
974,TALLURI PEDDA NAGESWARARAO,Independent,66,1,67,0.04,Gudivada,72,Andhra Pradesh 
975,VADDADI NAGA RAJU,Independent,87,2,89,0.05,Gudivada,72,Andhra Pradesh 
976,HASSAN AHMED ABDUL,Independent,230,0,230,0.13,Gudivada,72,Andhra Pradesh 
977,NOTA,None of the Above,981,18,999,0.58,Gudivada,72,Andhra Pradesh 
978,KAMINENI SRINIVAS,Bharatiya Janata Party,108311,969,109280,60.38,Kaikalur,73,Andhra Pradesh 
979,DULAM NAGESWARA RAO,Yuvajana Sramika Rythu Congress Party,63576,431,64007,35.36,Kaikalur,73,Andhra Pradesh 
980,NAGESWARA RAO MANEPALLI,Bahujan Samaj Party,802,1,803,0.44,Kaikalur,73,Andhra Pradesh 
981,BODDU NOBLE,Indian National Congress,2442,38,2480,1.37,Kaikalur,73,Andhra Pradesh 
982,KAMATAM NIRIKSHANA RAO,Bharatha Chaitanya Yuvajana Party,253,0,253,0.14,Kaikalur,73,Andhra Pradesh 
983,GONTHUPULUGU SATISH KUMAR,Jaibhim Rao Bharat Party,258,0,258,0.14,Kaikalur,73,Andhra Pradesh 
984,LAVETI VEERA SIVAJI,All India Forward Bloc,210,3,213,0.12,Kaikalur,73,Andhra Pradesh 
985,ALLUMOLU SOMESWARA RAO,Independent,356,0,356,0.2,Kaikalur,73,Andhra Pradesh 
986,KOPPULA VIJAYA BABU,Independent,70,1,71,0.04,Kaikalur,73,Andhra Pradesh 
987,KOTI SRINIVASA RAO,Independent,67,0,67,0.04,Kaikalur,73,Andhra Pradesh 
988,BALI GANESH,Independent,79,0,79,0.04,Kaikalur,73,Andhra Pradesh 
989,GUNUKULA NARAYANA,Independent,157,0,157,0.09,Kaikalur,73,Andhra Pradesh 
990,CHENNAMSETTI SOMA SUNDARA RAO,Independent,130,1,131,0.07,Kaikalur,73,Andhra Pradesh 
991,BODDU KIRAN KUMAR,Independent,178,1,179,0.1,Kaikalur,73,Andhra Pradesh 
992,MADASU SATYANARAYANA,Independent,1052,7,1059,0.59,Kaikalur,73,Andhra Pradesh 
993,NOTA,None of the Above,1588,10,1598,0.88,Kaikalur,73,Andhra Pradesh 
994,EDE KASI VISWESWARA RAO,Bahujan Samaj Party,440,9,449,0.3,Pedana,74,Andhra Pradesh 
995,UPPALA RAMESH(RAMU),Yuvajana Sramika Rythu Congress Party,52764,507,53271,35.52,Pedana,74,Andhra Pradesh 
996,KAGITHA KRISHNAPRASAD,Telugu Desam,90384,1010,91394,60.95,Pedana,74,Andhra Pradesh 
997,SONTI. NAGARAJU,Indian National Congress,1342,12,1354,0.9,Pedana,74,Andhra Pradesh 
998,KATRAGADDA VISHNU MURTHY,Yuga Thulasi Party,429,1,430,0.29,Pedana,74,Andhra Pradesh 
999,SABBISETTI. REVATHI DEVI,Pyramid Party of India,427,0,427,0.28,Pedana,74,Andhra Pradesh 
1000,KAGITHA SRI HARI KRISHNA PRASAD,Independent,186,3,189,0.13,Pedana,74,Andhra Pradesh 
1001,JAMADAGNI RAJULAPATI,Independent,163,1,164,0.11,Pedana,74,Andhra Pradesh 
1002,S.V. BABU,Independent,724,1,725,0.48,Pedana,74,Andhra Pradesh 
1003,SENAPATHI. GOPI,Independent,209,0,209,0.14,Pedana,74,Andhra Pradesh 
1004,NOTA,None of the Above,1341,8,1349,0.9,Pedana,74,Andhra Pradesh 
1005,ABDUL MATEEN,Indian National Congress,1393,50,1443,0.88,Machilipatnam,75,Andhra Pradesh 
1006,KOLLU. RAVINDRA,Telugu Desam,102460,2584,105044,63.73,Machilipatnam,75,Andhra Pradesh 
1007,PERNI KRISHNAMURTHY (KITTU),Yuvajana Sramika Rythu Congress Party,53760,1042,54802,33.25,Machilipatnam,75,Andhra Pradesh 
1008,SOWDADA. BALAJI,Bahujan Samaj Party,480,20,500,0.3,Machilipatnam,75,Andhra Pradesh 
1009,ADOTHU. TULASIRAM,Telugu Rajadhikara Samiti Party,162,0,162,0.1,Machilipatnam,75,Andhra Pradesh 
1010,KONA NAGARJUNA,Bharatha Chaitanya Yuvajana Party,837,1,838,0.51,Machilipatnam,75,Andhra Pradesh 
1011,VAKKALAGADDA PAVANI,Pyramid Party of India,198,0,198,0.12,Machilipatnam,75,Andhra Pradesh 
1012,AMMIREDDY RAJANI,Independent,60,1,61,0.04,Machilipatnam,75,Andhra Pradesh 
1013,ARIFPASHA SHAIK,Independent,66,1,67,0.04,Machilipatnam,75,Andhra Pradesh 
1014,ANGARA CHAMUNDESWARI,Independent,142,0,142,0.09,Machilipatnam,75,Andhra Pradesh 
1015,KOTAPROLU SUNEEL BABU,Independent,136,0,136,0.08,Machilipatnam,75,Andhra Pradesh 
1016,CHINTHAPALLI MANOHAR,Independent,96,2,98,0.06,Machilipatnam,75,Andhra Pradesh 
1017,EDE. BHASKARARAO,Independent,134,0,134,0.08,Machilipatnam,75,Andhra Pradesh 
1018,LAKSHMI KIRAN KUNAPAREDDY,Independent,187,0,187,0.11,Machilipatnam,75,Andhra Pradesh 
1019,NOTA,None of the Above,996,31,1027,0.62,Machilipatnam,75,Andhra Pradesh 
1020,ANDE SRI RAMAMURTHY,Indian National Congress,1043,25,1068,0.57,Avanigadda,76,Andhra Pradesh 
1021,GUNTURU NAGESWARARAO,Bahujan Samaj Party,423,13,436,0.23,Avanigadda,76,Andhra Pradesh 
1022,RAMESH BABU SIMHADRI,Yuvajana Sramika Rythu Congress Party,66142,884,67026,35.95,Avanigadda,76,Andhra Pradesh 
1023,AMBETHKAR. SAMUDRALA.,Jaibhim Rao Bharat Party,414,6,420,0.23,Avanigadda,76,Andhra Pradesh 
1024,NANCHARAIAH VENKATA MUNGARA,Pyramid Party of India,344,1,345,0.19,Avanigadda,76,Andhra Pradesh 
1025,BUDDHAPRASAD MANDALI,Janasena Party,110959,2501,113460,60.85,Avanigadda,76,Andhra Pradesh 
1026,BOYINA BUDDAPRASAD,Navarang Congress Party,688,1,689,0.37,Avanigadda,76,Andhra Pradesh 
1027,VENTRAPRAGADA. ANAND KUMAR,Jatiya Jana Sena Party,313,0,313,0.17,Avanigadda,76,Andhra Pradesh 
1028,GIRIDHAR NAIDU NADELLA,Independent,123,2,125,0.07,Avanigadda,76,Andhra Pradesh 
1029,CHANTI TANANKI,Independent,189,1,190,0.1,Avanigadda,76,Andhra Pradesh 
1030,NEELA. MANOHARA BABU,Independent,237,0,237,0.13,Avanigadda,76,Andhra Pradesh 
1031,MATHI PUSHPA KUMAR,Independent,183,1,184,0.1,Avanigadda,76,Andhra Pradesh 
1032,NOTA,None of the Above,1933,19,1952,1.05,Avanigadda,76,Andhra Pradesh 
1033,ANIL KUMAR KAILE,Yuvajana Sramika Rythu Congress Party,63719,780,64499,39.12,Pamarru,77,Andhra Pradesh 
1034,KUMAR RAJA VARLA,Telugu Desam,92853,1336,94189,57.13,Pamarru,77,Andhra Pradesh 
1035,D Y DAS,Indian National Congress,2195,38,2233,1.35,Pamarru,77,Andhra Pradesh 
1036,BABU RAJENDRAPRASAD. RAYAVARAPU,Bahujan Samaj Party,443,10,453,0.27,Pamarru,77,Andhra Pradesh 
1037,KODALI SUNEELA,Jaibhim Rao Bharat Party,199,0,199,0.12,Pamarru,77,Andhra Pradesh 
1038,NAYUDU. SIRISHA RANI,Jai Bharat National Party,460,2,462,0.28,Pamarru,77,Andhra Pradesh 
1039,M RAJA MANOHAR,Republican Party of India (A),814,2,816,0.49,Pamarru,77,Andhra Pradesh 
1040,SALE DINESH BABU.,Jatiya Jana Sena Party,284,1,285,0.17,Pamarru,77,Andhra Pradesh 
1041,NOTA,None of the Above,1722,11,1733,1.05,Pamarru,77,Andhra Pradesh 
1042,ELISALA SUBRAMANYAM,Indian National Congress,2562,34,2596,1.1,Penamaluru,78,Andhra Pradesh 
1043,JOGI RAMESH,Yuvajana Sramika Rythu Congress Party,83962,1035,84997,35.93,Penamaluru,78,Andhra Pradesh 
1044,BODE PRASAD,Telugu Desam,142757,2155,144912,61.26,Penamaluru,78,Andhra Pradesh 
1045,SOMU MAHESWARA RAO (MAHESH YADAV),Bahujan Samaj Party,708,8,716,0.3,Penamaluru,78,Andhra Pradesh 
1046,GURRALA HARSHITHA,Bharatha Chaitanya Yuvajana Party,184,1,185,0.08,Penamaluru,78,Andhra Pradesh 
1047,CHAKKA. YEDUKONDALU,Pyramid Party of India,585,0,585,0.25,Penamaluru,78,Andhra Pradesh 
1048,SASIDHAR MAREEDU,Telugu Rajadhikara Samiti Party,165,0,165,0.07,Penamaluru,78,Andhra Pradesh 
1049,SADARLA. PRASADA RAO,Jaibhim Rao Bharat Party,129,1,130,0.05,Penamaluru,78,Andhra Pradesh 
1050,KANAKA DURGA RAO. PACHIPALA,Independent,458,0,458,0.19,Penamaluru,78,Andhra Pradesh 
1051,GOGAM RAMU,Independent,140,0,140,0.06,Penamaluru,78,Andhra Pradesh 
1052,MARADANI VIEZAYAA,Independent,145,0,145,0.06,Penamaluru,78,Andhra Pradesh 
1053,NOTA,None of the Above,1486,24,1510,0.64,Penamaluru,78,Andhra Pradesh 
1054,ASIF SHAIK,Yuvajana Sramika Rythu Congress Party,57988,649,58637,34.12,Vijayawada West,79,Andhra Pradesh 
1055,MADDIRALA VINOD KUMAR,Bahujan Samaj Party,958,20,978,0.57,Vijayawada West,79,Andhra Pradesh 
1056,YALAMANCHILI SATYANARAYANA CHOWDARY,Bharatiya Janata Party,104717,952,105669,61.49,Vijayawada West,79,Andhra Pradesh 
1057,KONAKI VENKATESWARA RAO,Studentz United For Nation Party,241,0,241,0.14,Vijayawada West,79,Andhra Pradesh 
1058,KOTESWARA RAO GUMMADIDALA,Communist Party of India,3654,69,3723,2.17,Vijayawada West,79,Andhra Pradesh 
1059,KHADAR BASHA SHAIK,Marxist Communist Party of India (United),124,2,126,0.07,Vijayawada West,79,Andhra Pradesh 
1060,TADANKI JAGADISH RAMACHANDRA RAO,Telugu Rajadhikara Samiti Party,53,2,55,0.03,Vijayawada West,79,Andhra Pradesh 
1061,NAKKALA SAI BABU,Navarang Congress Party,186,3,189,0.11,Vijayawada West,79,Andhra Pradesh 
1062,PARASA SURESH KUMAR,Jaibhim Rao Bharat Party,164,4,168,0.1,Vijayawada West,79,Andhra Pradesh 
1063,POTHINA VENKATA RAMARAO,Jai Bharat National Party,294,4,298,0.17,Vijayawada West,79,Andhra Pradesh 
1064,MOHANA DURGA PRASAD TADEPALLI,Pyramid Party of India,88,0,88,0.05,Vijayawada West,79,Andhra Pradesh 
1065,RAMANA PRASAD KOTHAMASU,Samajwadi Party,39,0,39,0.02,Vijayawada West,79,Andhra Pradesh 
1066,SHAIK KHAJA VALI,Indian Union Muslim League,139,2,141,0.08,Vijayawada West,79,Andhra Pradesh 
1067,VIDAVALAPATI VIJAYA SANKAR,Independent,105,0,105,0.06,Vijayawada West,79,Andhra Pradesh 
1068,SEERAM NAGAMALLESWARA RAO,Independent,148,2,150,0.09,Vijayawada West,79,Andhra Pradesh 
1069,NOTA,None of the Above,1204,32,1236,0.72,Vijayawada West,79,Andhra Pradesh 
1070,INAPANURI RAJENDRA PRASAD,Bahujan Samaj Party,1937,5,1942,0.95,Vijayawada Central,80,Andhra Pradesh 
1071,CHIGURUPATI BABU RAO,Communist Party of India (Marxist),4741,146,4887,2.39,Vijayawada Central,80,Andhra Pradesh 
1072,BONDA UMAMAHESWARARAO,Telugu Desam,128376,1658,130034,63.52,Vijayawada Central,80,Andhra Pradesh 
1073,VELAMPALLI SRINIVASA RAO,Yuvajana Sramika Rythu Congress Party,60274,874,61148,29.87,Vijayawada Central,80,Andhra Pradesh 
1074,GOLLAPALLI SREE PHANI RAJ,Andhra Rastra Praja Samithi,3573,28,3601,1.76,Vijayawada Central,80,Andhra Pradesh 
1075,THRINADHA SWAMY BUNGA,Pyramid Party of India,128,0,128,0.06,Vijayawada Central,80,Andhra Pradesh 
1076,PRASANTH KUMAR MALAPOLU,Navarang Congress Party,56,0,56,0.03,Vijayawada Central,80,Andhra Pradesh 
1077,K SIVA SANKAR,Jatiya Jana Sena Party,48,1,49,0.02,Vijayawada Central,80,Andhra Pradesh 
1078,SRIDHARA DAKSHINA MURTHY,Jai Bharat National Party,74,1,75,0.04,Vijayawada Central,80,Andhra Pradesh 
1079,L. HIMAVADVATHI,Socialist Unity Centre Of India (COMMUNIST),46,1,47,0.02,Vijayawada Central,80,Andhra Pradesh 
1080,KONIJETI ADINARAYANA,Independent,37,0,37,0.02,Vijayawada Central,80,Andhra Pradesh 
1081,CHANDRASEKHAR PEDAPATI,Independent,57,1,58,0.03,Vijayawada Central,80,Andhra Pradesh 
1082,V. JAYA POORNACHANDRA RAO,Independent,95,2,97,0.05,Vijayawada Central,80,Andhra Pradesh 
1083,DASARI NAGARAJU,Independent,96,2,98,0.05,Vijayawada Central,80,Andhra Pradesh 
1084,DUGGISETTI SUBHASHINI,Independent,113,2,115,0.06,Vijayawada Central,80,Andhra Pradesh 
1085,BOPPANA GANDHI,Independent,306,0,306,0.15,Vijayawada Central,80,Andhra Pradesh 
1086,BHARTHEPUDI VENKATA SAI LAKSHMI GANESH,Independent,263,0,263,0.13,Vijayawada Central,80,Andhra Pradesh 
1087,MANNAM. RAJA SEKHAR (RAJA),Independent,171,1,172,0.08,Vijayawada Central,80,Andhra Pradesh 
1088,RAMALINGESWARA RAO JONNAVITTULA,Independent,492,7,499,0.24,Vijayawada Central,80,Andhra Pradesh 
1089,VANTIKOMMU BHOOPAL REDDY,Independent,154,0,154,0.08,Vijayawada Central,80,Andhra Pradesh 
1090,NOTA,None of the Above,914,37,951,0.46,Vijayawada Central,80,Andhra Pradesh 
1091,AVINASH DEVINENI,Yuvajana Sramika Rythu Congress Party,68197,1004,69201,35.32,Vijayawada East,81,Andhra Pradesh 
1092,KANAPARTHI MURALI,Bahujan Samaj Party,1070,2,1072,0.55,Vijayawada East,81,Andhra Pradesh 
1093,GADDE RAMA MOHAN,Telugu Desam,116950,1891,118841,60.66,Vijayawada East,81,Andhra Pradesh 
1094,PONUGUPATI NANCHARAIAH,Indian National Congress,2210,34,2244,1.15,Vijayawada East,81,Andhra Pradesh 
1095,ANIL KUMAR JALDI,Navarang Congress Party,83,4,87,0.04,Vijayawada East,81,Andhra Pradesh 
1096,GOTLURI. S. NAGA LAKSHMI,Pyramid Party of India,94,0,94,0.05,Vijayawada East,81,Andhra Pradesh 
1097,JETTI VASUNDHARA,Jatiya Jana Sena Party,80,0,80,0.04,Vijayawada East,81,Andhra Pradesh 
1098,DASHARATH KUNAPAREDDY,All India Jaihind Party,2739,26,2765,1.41,Vijayawada East,81,Andhra Pradesh 
1099,MURALI KRISHNA NAIDU Y,Jai Bharat National Party,53,1,54,0.03,Vijayawada East,81,Andhra Pradesh 
1100,MENDEM VIJAYA SEKHAR,Jaibhim Rao Bharat Party,42,3,45,0.02,Vijayawada East,81,Andhra Pradesh 
1101,VINAY KUMAR THAMBI YEMMILA,Telugu Rajadhikara Samiti Party,49,2,51,0.03,Vijayawada East,81,Andhra Pradesh 
1102,VENKATA REDDY GANGI REDDY,Studentz United For Nation Party,66,0,66,0.03,Vijayawada East,81,Andhra Pradesh 
1103,AVINASH SIDDELA,Independent,50,1,51,0.03,Vijayawada East,81,Andhra Pradesh 
1104,BHARGAV MEDABALIMI,Independent,78,0,78,0.04,Vijayawada East,81,Andhra Pradesh 
1105,RAM MOHAN RAO G,Independent,124,4,128,0.07,Vijayawada East,81,Andhra Pradesh 
1106,NOTA,None of the Above,1027,22,1049,0.54,Vijayawada East,81,Andhra Pradesh 
1107,KIRAN BORRA,Indian National Congress,4616,36,4652,1.92, Mylavaram,82,Andhra Pradesh 
1108,GALANKI.VENKATESWARA RAO,Bahujan Samaj Party,1510,5,1515,0.62, Mylavaram,82,Andhra Pradesh 
1109,TIRAPATHIRAO SARNALA,Yuvajana Sramika Rythu Congress Party,93607,902,94509,38.96, Mylavaram,82,Andhra Pradesh 
1110,VASANTHA VENKATA KRISHNA PRASAD,Telugu Desam,135875,1463,137338,56.61, Mylavaram,82,Andhra Pradesh 
1111,ANIL KUMAR POLAKAMPALLI,Jatiya Jana Sena Party,341,0,341,0.14, Mylavaram,82,Andhra Pradesh 
1112,ORSU RAMARAO,Jai Bharat National Party,190,1,191,0.08, Mylavaram,82,Andhra Pradesh 
1113,NAVEEN AMBEDKAR CHINTAMALA,Telugu Rajadhikara Samiti Party,111,0,111,0.05, Mylavaram,82,Andhra Pradesh 
1114,RAMBABU GUDISA,Navarang Congress Party,85,0,85,0.04, Mylavaram,82,Andhra Pradesh 
1115,KOLIKAPOGU VENKATA RAO,Independent,72,0,72,0.03, Mylavaram,82,Andhra Pradesh 
1116,PULLARAO NAMBURI,Independent,131,0,131,0.05, Mylavaram,82,Andhra Pradesh 
1117,PRUDHVI VEMULAPALLI,Independent,147,2,149,0.06, Mylavaram,82,Andhra Pradesh 
1118,VALLABHANENI. NAGA PAVAN KUMAR,Independent,1890,15,1905,0.79, Mylavaram,82,Andhra Pradesh 
1119,NOTA,None of the Above,1579,19,1598,0.66, Mylavaram,82,Andhra Pradesh 
1120,TANGIRALA SOWMYA,Telugu Desam,101042,1159,102201,56.16,Nandigama (SC),83,Andhra Pradesh 
1121,BARRE. UDAYA KIRAN,Bahujan Samaj Party,2129,19,2148,1.18,Nandigama (SC),83,Andhra Pradesh 
1122,MONDITOKA JAGAN MOHAN RAO,Yuvajana Sramika Rythu Congress Party,73974,832,74806,41.1,Nandigama (SC),83,Andhra Pradesh 
1123,VAJRAIAH. MANDA,Indian National Congress,1468,18,1486,0.82,Nandigama (SC),83,Andhra Pradesh 
1124,KATARAPU SANTHARAO,Samajwadi Party,103,0,103,0.06,Nandigama (SC),83,Andhra Pradesh 
1125,PANITI. LAL,Jai Maha Bharath Party,43,1,44,0.02,Nandigama (SC),83,Andhra Pradesh 
1126,BEZAWADA GOPI,Jaibhim Rao Bharat Party,82,0,82,0.05,Nandigama (SC),83,Andhra Pradesh 
1127,NIPPULAPALLI KOTESWARARAO,Independent,82,1,83,0.05,Nandigama (SC),83,Andhra Pradesh 
1128,SUNDARA RAO. KOTTAPALLI,Independent,109,1,110,0.06,Nandigama (SC),83,Andhra Pradesh 
1129,NOTA,None of the Above,920,8,928,0.51,Nandigama (SC),83,Andhra Pradesh 
1130,APPARAO KARNATI,Indian National Congress,2516,11,2527,1.36,Jaggayyapeta,84,Andhra Pradesh 
1131,UDAYA BHANU SAMINENI,Yuvajana Sramika Rythu Congress Party,81510,992,82502,44.38,Jaggayyapeta,84,Andhra Pradesh 
1132,KODAMALA PRABHUDAS,Bahujan Samaj Party,698,4,702,0.38,Jaggayyapeta,84,Andhra Pradesh 
1133,RAJAGOPAL SREERAM (TATAIAH),Telugu Desam,97272,1207,98479,52.98,Jaggayyapeta,84,Andhra Pradesh 
1134,RAMBABU GUDISA,Telugu Rajadhikara Samiti Party,211,0,211,0.11,Jaggayyapeta,84,Andhra Pradesh 
1135,AYALAPOGU VENKATESWARLU,Independent,76,1,77,0.04,Jaggayyapeta,84,Andhra Pradesh 
1136,KANDULA NARASIMHA RAO,Independent,28,0,28,0.02,Jaggayyapeta,84,Andhra Pradesh 
1137,GOPINADH . CHEKURI,Independent,22,0,22,0.01,Jaggayyapeta,84,Andhra Pradesh 
1138,JAMA. ANANDA RAO,Independent,16,1,17,0.01,Jaggayyapeta,84,Andhra Pradesh 
1139,JONNAKUTI AHARONU,Independent,33,0,33,0.02,Jaggayyapeta,84,Andhra Pradesh 
1140,BEROTHULA PRAKASA RAO,Independent,316,6,322,0.17,Jaggayyapeta,84,Andhra Pradesh 
1141,MEDEPALLI FRANSIS,Independent,45,0,45,0.02,Jaggayyapeta,84,Andhra Pradesh 
1142,VELPULA. VIJAY (KUMAR),Independent,149,0,149,0.08,Jaggayyapeta,84,Andhra Pradesh 
1143,NOTA,None of the Above,755,18,773,0.42,Jaggayyapeta,84,Andhra Pradesh 
1144,NAMBURU SANKARA RAO,Yuvajana Sramika Rythu Congress Party,91048,820,91868,43.89,Pedakurapadu,85,Andhra Pradesh 
1145,PAMIDI NAGESWARA RAO,Indian National Congress,1280,10,1290,0.62,Pedakurapadu,85,Andhra Pradesh 
1146,BHASHYAM PRAVEEN,Telugu Desam,111980,977,112957,53.97,Pedakurapadu,85,Andhra Pradesh 
1147,VARAGANI EDUKONDALU,Bahujan Samaj Party,1029,1,1030,0.49,Pedakurapadu,85,Andhra Pradesh 
1148,ALA RAMAKRISHNA RAO,Bharatha Chaitanya Yuvajana Party,135,5,140,0.07,Pedakurapadu,85,Andhra Pradesh 
1149,KALYAN CHAKRAVARTHY NAMBURU,Independent,489,1,490,0.23,Pedakurapadu,85,Andhra Pradesh 
1150,GOWTUKATLA ANKAMMARAO,Independent,59,0,59,0.03,Pedakurapadu,85,Andhra Pradesh 
1151,PARAGATI RAJU,Independent,47,1,48,0.02,Pedakurapadu,85,Andhra Pradesh 
1152,BANAVATHU MURALIKRISHNA NAIK,Independent,41,0,41,0.02,Pedakurapadu,85,Andhra Pradesh 
1153,BANKA THIRUPATHAIAH,Independent,90,0,90,0.04,Pedakurapadu,85,Andhra Pradesh 
1154,SETTI SINGARAIAH,Independent,101,0,101,0.05,Pedakurapadu,85,Andhra Pradesh 
1155,NOTA,None of the Above,1170,14,1184,0.57,Pedakurapadu,85,Andhra Pradesh 
1156,TENALI SRAVAN KUMAR,Telugu Desam,108346,1239,109585,59.52,Tadikonda (SC),86,Andhra Pradesh 
1157,MANCHALA SUSHIL RAJA,Indian National Congress,2492,22,2514,1.37,Tadikonda (SC),86,Andhra Pradesh 
1158,SRUNGARAPATI BABURAO,Bahujan Samaj Party,487,5,492,0.27,Tadikonda (SC),86,Andhra Pradesh 
1159,SUCHARITHA MEKATHOTI,Yuvajana Sramika Rythu Congress Party,69302,677,69979,38.01,Tadikonda (SC),86,Andhra Pradesh 
1160,GURRAM RAMARAO,Navarang Congress Party,182,1,183,0.1,Tadikonda (SC),86,Andhra Pradesh 
1161,JADA SRAVAN KUMAR,Jaibhim Rao Bharat Party,71,0,71,0.04,Tadikonda (SC),86,Andhra Pradesh 
1162,MUSALAIAH DODDA,Indian Labour Party (Ambedkar Phule),40,0,40,0.02,Tadikonda (SC),86,Andhra Pradesh 
1163,MENDEM MARIYADASU,Telugu Rajadhikara Samiti Party,92,0,92,0.05,Tadikonda (SC),86,Andhra Pradesh 
1164,RAMESH BABU TENALI,Jatiya Jana Sena Party,65,0,65,0.04,Tadikonda (SC),86,Andhra Pradesh 
1165,RAVELA YESAYA,Independent,84,0,84,0.05,Tadikonda (SC),86,Andhra Pradesh 
1166,NOTA,None of the Above,988,7,995,0.54,Tadikonda (SC),86,Andhra Pradesh 
1167,KURAPATI SUBBARAO,Bahujan Samaj Party,971,5,976,0.38,Mangalagiri,87,Andhra Pradesh 
1168,JONNA SIVASANKARARAO,Communist Party of India (Marxist),2600,29,2629,1.04,Mangalagiri,87,Andhra Pradesh 
1169,NARA LOKESH,Telugu Desam,165512,2198,167710,66.07,Mangalagiri,87,Andhra Pradesh 
1170,MURUGUDU LAVANYA,Yuvajana Sramika Rythu Congress Party,75352,945,76297,30.06,Mangalagiri,87,Andhra Pradesh 
1171,ANNAPUREDDY KRISHNAREDDY,Studentz United For Nation Party,163,2,165,0.07,Mangalagiri,87,Andhra Pradesh 
1172,ABDUL GAFFAR SHARIF,Indian Union Muslim League,103,0,103,0.04,Mangalagiri,87,Andhra Pradesh 
1173,KANCHARLA MARY SAILAJA,Telugu Vijayam Party,40,1,41,0.02,Mangalagiri,87,Andhra Pradesh 
1174,KAKI VENKATARAO,Indian Labour Party (Ambedkar Phule),19,0,19,0.01,Mangalagiri,87,Andhra Pradesh 
1175,KOSANAM SRINIVASARAO,Jaathia Chethi Vruthula Ikya Vedika Party,37,0,37,0.01,Mangalagiri,87,Andhra Pradesh 
1176,GURRAM RAMARAO,Prabuddha Republican Party,29,0,29,0.01,Mangalagiri,87,Andhra Pradesh 
1177,JANJANAM KOTESWARARAO,Telugu Rajadhikara Samiti Party,41,0,41,0.02,Mangalagiri,87,Andhra Pradesh 
1178,TAMMISETTY KOTAMMA,National Nava Kranthi Party,44,1,45,0.02,Mangalagiri,87,Andhra Pradesh 
1179,PUSALA VENKATA KRISHNAIAH,Mana Desam Party,43,0,43,0.02,Mangalagiri,87,Andhra Pradesh 
1180,BODE RAMACHANDRA YADAV,Bharatha Chaitanya Yuvajana Party,369,4,373,0.15,Mangalagiri,87,Andhra Pradesh 
1181,RAVU SUBRAHMANYAM,Navataram Party,1048,4,1052,0.41,Mangalagiri,87,Andhra Pradesh 
1182,VENKATA NAGALAKSHMI DESU,Pyramid Party of India,190,0,190,0.07,Mangalagiri,87,Andhra Pradesh 
1183,SRAVAN KUMAR JADA,Jaibhim Rao Bharat Party,413,3,416,0.16,Mangalagiri,87,Andhra Pradesh 
1184,SHAIK. JALEEL,Navarang Congress Party,285,2,287,0.11,Mangalagiri,87,Andhra Pradesh 
1185,ALLA RAMAKRISHNA,Independent,675,0,675,0.27,Mangalagiri,87,Andhra Pradesh 
1186,KANAKADURGA DIVVELA,Independent,164,1,165,0.07,Mangalagiri,87,Andhra Pradesh 
1187,KASUKURTHI NAVEEN,Independent,62,0,62,0.02,Mangalagiri,87,Andhra Pradesh 
1188,KASANI SUDHAKAR BABU,Independent,36,0,36,0.01,Mangalagiri,87,Andhra Pradesh 
1189,GANJI SHANMUKH,Independent,65,1,66,0.03,Mangalagiri,87,Andhra Pradesh 
1190,CHADALAVADA VENKATA RAMESH,Independent,34,0,34,0.01,Mangalagiri,87,Andhra Pradesh 
1191,CHIKKA BALA SURYA PRAKASH,Independent,43,0,43,0.02,Mangalagiri,87,Andhra Pradesh 
1192,JAMMULA LOKESWARARAO (LOKESH),Independent,24,0,24,0.01,Mangalagiri,87,Andhra Pradesh 
1193,DANABOINA VENKATA SIVAJI,Independent,27,1,28,0.01,Mangalagiri,87,Andhra Pradesh 
1194,NANDIPALLI SRINIVASARAO,Independent,30,0,30,0.01,Mangalagiri,87,Andhra Pradesh 
1195,NAGARAJU GUTTA,Independent,31,0,31,0.01,Mangalagiri,87,Andhra Pradesh 
1196,NAINALA. LAVANYA,Independent,33,1,34,0.01,Mangalagiri,87,Andhra Pradesh 
1197,PUTCHALA NAGESWARARAO,Independent,29,0,29,0.01,Mangalagiri,87,Andhra Pradesh 
1198,PRASANNA KUMAR MADUPU B.COM,Independent,109,0,109,0.04,Mangalagiri,87,Andhra Pradesh 
1199,BIKSHAMAIAH. BANDLA,Independent,464,0,464,0.18,Mangalagiri,87,Andhra Pradesh 
1200,RAVURI KISHORE BABU,Independent,120,1,121,0.05,Mangalagiri,87,Andhra Pradesh 
1201,LOKESWARARAO MUNAGALA,Independent,274,0,274,0.11,Mangalagiri,87,Andhra Pradesh 
1202,VALAPARLA. KISHORE,Independent,86,3,89,0.04,Mangalagiri,87,Andhra Pradesh 
1203,VINAY KUMAR THAMBI YEMMILA,Independent,115,0,115,0.05,Mangalagiri,87,Andhra Pradesh 
1204,SYAMALANANDA PRASAD PALAPARTHI,Independent,25,0,25,0.01,Mangalagiri,87,Andhra Pradesh 
1205,SRIKRISHNA AKKISETTI,Independent,10,0,10,,Mangalagiri,87,Andhra Pradesh 
1206,SHAIK RAHIM,Independent,23,0,23,0.01,Mangalagiri,87,Andhra Pradesh 
1207,NOTA,None of the Above,877,13,890,0.35,Mangalagiri,87,Andhra Pradesh 
1208,AMBATI MURALI KRISHNA,Yuvajana Sramika Rythu Congress Party,76634,861,77495,39.97,Ponnur,88,Andhra Pradesh 
1209,KISHORE YATATI,Bahujan Samaj Party,1439,12,1451,0.75,Ponnur,88,Andhra Pradesh 
1210,JAKKA RAVINDRANATH,Indian National Congress,2343,57,2400,1.24,Ponnur,88,Andhra Pradesh 
1211,DHULIPALLA NARENDRA KUMAR,Telugu Desam,108843,1567,110410,56.95,Ponnur,88,Andhra Pradesh 
1212,AKKIDASU JOSEPH,Reforms Party of India,216,1,217,0.11,Ponnur,88,Andhra Pradesh 
1213,DR KURAPATI MANIKYA RAO.,Viduthalai Chiruthaigal Katchi,108,1,109,0.06,Ponnur,88,Andhra Pradesh 
1214,DR GALINKI JOHN SAMUEL,Indian Labour Party (Ambedkar Phule),42,1,43,0.02,Ponnur,88,Andhra Pradesh 
1215,GONA RABORT,Telugu Rajadhikara Samiti Party,48,0,48,0.02,Ponnur,88,Andhra Pradesh 
1216,JONNADULA RAMESH,Pyramid Party of India,90,0,90,0.05,Ponnur,88,Andhra Pradesh 
1217,MODDU SAMBASIVA RAO,Jaibhim Rao Bharat Party,40,2,42,0.02,Ponnur,88,Andhra Pradesh 
1218,VARIKUNTA ROSAIAH,Jai Bharat National Party,50,2,52,0.03,Ponnur,88,Andhra Pradesh 
1219,SHEK MASTAN VALI,Navarang Congress Party,99,1,100,0.05,Ponnur,88,Andhra Pradesh 
1220,DOPPALAPUDI VASUDEVA RAO,Independent,73,3,76,0.04,Ponnur,88,Andhra Pradesh 
1221,LAKSHMANARAO ADALA,Independent,94,0,94,0.05,Ponnur,88,Andhra Pradesh 
1222,NOTA,None of the Above,1234,14,1248,0.64,Ponnur,88,Andhra Pradesh 
1223,ASHOK BABU VARIKUTI,Yuvajana Sramika Rythu Congress Party,72155,746,72901,42.18,Vemuru (SC),89,Andhra Pradesh 
1224,ANANDA BABU NAKKA,Telugu Desam,93671,1251,94922,54.92,Vemuru (SC),89,Andhra Pradesh 
1225,GORIKAPUDI STEEVEN,Bahujan Samaj Party,674,7,681,0.39,Vemuru (SC),89,Andhra Pradesh 
1226,BURAGA SUBBA RAO,Indian National Congress,1651,13,1664,0.96,Vemuru (SC),89,Andhra Pradesh 
1227,KATTAPOGU VIJAYAKUMAR,Pyramid Party of India,74,1,75,0.04,Vemuru (SC),89,Andhra Pradesh 
1228,TAMANAM BHUSHANAM,Samajwadi Party,74,0,74,0.04,Vemuru (SC),89,Andhra Pradesh 
1229,DURU BHAGYA RAJU,Jai Bharat National Party,131,1,132,0.08,Vemuru (SC),89,Andhra Pradesh 
1230,PAMULA VIJAYA KUMARI,Liberation Congress Party,39,0,39,0.02,Vemuru (SC),89,Andhra Pradesh 
1231,YALLAMATI SYAM PRASAD,Jaibhim Rao Bharat Party,52,1,53,0.03,Vemuru (SC),89,Andhra Pradesh 
1232,RAVEENDRABABU JADA,Jatiya Jana Sena Party,53,0,53,0.03,Vemuru (SC),89,Andhra Pradesh 
1233,KANAPARTHI SHARATHBABU,Independent,69,1,70,0.04,Vemuru (SC),89,Andhra Pradesh 
1234,KOLAKALURI VIJAY PAUL,Independent,39,0,39,0.02,Vemuru (SC),89,Andhra Pradesh 
1235,GADDE VIJAYALAKSHMI,Independent,76,1,77,0.04,Vemuru (SC),89,Andhra Pradesh 
1236,NAIDU NIKHIL KRISHNA,Independent,144,2,146,0.08,Vemuru (SC),89,Andhra Pradesh 
1237,BODIYYA CHEBROLU,Independent,160,2,162,0.09,Vemuru (SC),89,Andhra Pradesh 
1238,NOTA,None of the Above,1747,16,1763,1.02,Vemuru (SC),89,Andhra Pradesh 
1239,ANAGANI SATYA PRASAD,Telugu Desam,108462,2667,111129,58.85,Repalle,90,Andhra Pradesh 
1240,EVURU GANESH,Yuvajana Sramika Rythu Congress Party,70263,919,71182,37.7,Repalle,90,Andhra Pradesh 
1241,DOKKA SRINIVISA RAO,Bahujan Samaj Party,720,10,730,0.39,Repalle,90,Andhra Pradesh 
1242,MOPIDEVI SRINIVASA RAO,Indian National Congress,2772,69,2841,1.5,Repalle,90,Andhra Pradesh 
1243,ANGIREKULA ADI NARAYANA,Bharatha Chaitanya Yuvajana Party,136,6,142,0.08,Repalle,90,Andhra Pradesh 
1244,ANDRAJU RAMARAJU,Jai Bharat National Party,75,4,79,0.04,Repalle,90,Andhra Pradesh 
1245,DOVA RAMESH RAMJI,Jaibhim Rao Bharat Party,130,2,132,0.07,Repalle,90,Andhra Pradesh 
1246,MERUGUPALA SADASIVA RAO,India Praja Bandhu Party,89,2,91,0.05,Repalle,90,Andhra Pradesh 
1247,YADLA GOPIRAJU,Jatiya Jana Sena Party,59,2,61,0.03,Repalle,90,Andhra Pradesh 
1248,SUBBARAO BELLAMKONDA,Pyramid Party of India,68,1,69,0.04,Repalle,90,Andhra Pradesh 
1249,HASEENA SHAIK,Indian Union Muslim League,67,1,68,0.04,Repalle,90,Andhra Pradesh 
1250,KOKKILIGADDA RAMBABU,Independent,72,0,72,0.04,Repalle,90,Andhra Pradesh 
1251,BODDU NAGESWARARAO,Independent,98,1,99,0.05,Repalle,90,Andhra Pradesh 
1252,MAHAMMAD KHASEEM,Independent,245,1,246,0.13,Repalle,90,Andhra Pradesh 
1253,NOTA,None of the Above,1876,15,1891,1,Repalle,90,Andhra Pradesh 
1254,ANNABATHUNI SIVAKUMAR,Yuvajana Sramika Rythu Congress Party,74682,1167,75849,36.82,Tenali,91,Andhra Pradesh 
1255,KARUMANCHI SUNIL SUNDEEP,Bahujan Samaj Party,2168,20,2188,1.06,Tenali,91,Andhra Pradesh 
1256,AMANULLA KHAN PATHAN,Indian Union Muslim League,343,1,344,0.17,Tenali,91,Andhra Pradesh 
1257,KONDURI NAGARAJU,Telugu Janata Party,130,5,135,0.07,Tenali,91,Andhra Pradesh 
1258,CHUKKAPALLI PRASAD,Telugu Vijayam Party,239,0,239,0.12,Tenali,91,Andhra Pradesh 
1259,JINKA MALLIKARJUNA RAO,Pyramid Party of India,471,1,472,0.23,Tenali,91,Andhra Pradesh 
1260,NADENDLA MANOHAR,Janasena Party,121927,2034,123961,60.18,Tenali,91,Andhra Pradesh 
1261,SHAVALA GOPAL,Communist Party of India (Marxist-Leninist) (Liberation),307,0,307,0.15,Tenali,91,Andhra Pradesh 
1262,SHAIK BASHA,Jai Bharat National Party,160,2,162,0.08,Tenali,91,Andhra Pradesh 
1263,GADE RAMAKRISHNA,Independent,123,1,124,0.06,Tenali,91,Andhra Pradesh 
1264,TUMAPALA NARENDRA,Independent,459,3,462,0.22,Tenali,91,Andhra Pradesh 
1265,YANDRAPATI ASHOK KUMAR,Independent,136,3,139,0.07,Tenali,91,Andhra Pradesh 
1266,LAKSHMANAMURTHY KOTA,Independent,202,0,202,0.1,Tenali,91,Andhra Pradesh 
1267,NOTA,None of the Above,1382,30,1412,0.69,Tenali,91,Andhra Pradesh 
1268,ANJIBABU GANTA,Indian National Congress,4088,105,4193,2.6,Bapatla,92,Andhra Pradesh 
1269,KONA RAGHUPATHI,Yuvajana Sramika Rythu Congress Party,62027,831,62858,38.99,Bapatla,92,Andhra Pradesh 
1270,GUDE RAJARAO,Bahujan Samaj Party,1047,7,1054,0.65,Bapatla,92,Andhra Pradesh 
1271,VEGESANA NARENDRA VARMA RAJU,Telugu Desam,88827,1799,90626,56.21,Bapatla,92,Andhra Pradesh 
1272,DEVARAKONDA RAJESWARA RAO,Pyramid Party of India,259,2,261,0.16,Bapatla,92,Andhra Pradesh 
1273,REGULAGADDA CHANDRA SEKHARARAO,Viduthalai Chiruthaigal Katchi,68,0,68,0.04,Bapatla,92,Andhra Pradesh 
1274,SRINIVASA RAO GORLA,Samajwadi Party,63,4,67,0.04,Bapatla,92,Andhra Pradesh 
1275,KATIKALA SIVABHAGYARAO,Independent,118,10,128,0.08,Bapatla,92,Andhra Pradesh 
1276,KOCHARA VINAYARAJU,Independent,42,1,43,0.03,Bapatla,92,Andhra Pradesh 
1277,DENDUKURI SITA RAMA RAJU,Independent,407,5,412,0.26,Bapatla,92,Andhra Pradesh 
1278,PITTU. BUSI REDDY,Independent,39,0,39,0.02,Bapatla,92,Andhra Pradesh 
1279,P. PRASAD,Independent,46,1,47,0.03,Bapatla,92,Andhra Pradesh 
1280,BETHALAM YASWANTH,Independent,57,1,58,0.04,Bapatla,92,Andhra Pradesh 
1281,MARUPROLU. CHENNAKESAVAREDDY,Independent,101,0,101,0.06,Bapatla,92,Andhra Pradesh 
1282,D.SAALINI,Independent,142,1,143,0.09,Bapatla,92,Andhra Pradesh 
1283,NOTA,None of the Above,1113,15,1128,0.7,Bapatla,92,Andhra Pradesh 
1284,KORIVI VINAYA KUMAR,Indian National Congress,3448,43,3491,1.58, Prathipadu,93,Andhra Pradesh 
1285,BALASANI KIRAN KUMAR,Yuvajana Sramika Rythu Congress Party,85652,998,86650,39.12, Prathipadu,93,Andhra Pradesh 
1286,BURLA RAMANJANEYULU,Telugu Desam,126988,1677,128665,58.09, Prathipadu,93,Andhra Pradesh 
1287,MURALIDHAR .G,Bahujan Samaj Party,351,5,356,0.16, Prathipadu,93,Andhra Pradesh 
1288,CHALLA SARATHKUMAR,Pyramid Party of India,128,0,128,0.06, Prathipadu,93,Andhra Pradesh 
1289,PALLAPATI NAVEEN,Jai Bharat National Party,74,1,75,0.03, Prathipadu,93,Andhra Pradesh 
1290,PAUL YANDRAPATI,Indian Labour Party (Ambedkar Phule),52,1,53,0.02, Prathipadu,93,Andhra Pradesh 
1291,BURRI RAMBABU,Jatiya Jana Sena Party,48,2,50,0.02, Prathipadu,93,Andhra Pradesh 
1292,S.S. RANI (MAHALAKSHMI),Bharatha Chaitanya Yuvajana Party,90,3,93,0.04, Prathipadu,93,Andhra Pradesh 
1293,KATHI ARUN KUMAR,Independent,73,0,73,0.03, Prathipadu,93,Andhra Pradesh 
1294,CHANDRAM KRISHANAMRAJU,Independent,151,2,153,0.07, Prathipadu,93,Andhra Pradesh 
1295,BEJJAM NAGARAJU,Independent,112,2,114,0.05, Prathipadu,93,Andhra Pradesh 
1296,K. RAJINI KANTH,Independent,189,0,189,0.09, Prathipadu,93,Andhra Pradesh 
1297,NOTA,None of the Above,1373,16,1389,0.63, Prathipadu,93,Andhra Pradesh 
1298,GALLA MADHAVI,Telugu Desam,113012,3055,116067,61.58,Guntur West,94,Andhra Pradesh 
1299,JOHN BABU RACHAKONDA,Indian National Congress,3616,103,3719,1.97,Guntur West,94,Andhra Pradesh 
1300,RAJINI VIDADALA,Yuvajana Sramika Rythu Congress Party,63290,1627,64917,34.44,Guntur West,94,Andhra Pradesh 
1301,ALLA. KRISHNA KISHORE,Navodayam Party,143,0,143,0.08,Guntur West,94,Andhra Pradesh 
1302,UMAR BASHA SHAIK,Jana Sahayaka Sakthi,92,0,92,0.05,Guntur West,94,Andhra Pradesh 
1303,KOTAPATI. SURESH.,Pyramid Party of India,51,0,51,0.03,Guntur West,94,Andhra Pradesh 
1304,CHUKKA ARAVIND,Telugu Rajadhikara Samiti Party,20,0,20,0.01,Guntur West,94,Andhra Pradesh 
1305,CHERUKUPALLI JOSHI RANGANATH,Jai Bharat National Party,41,0,41,0.02,Guntur West,94,Andhra Pradesh 
1306,THIRLIKA. SANKAR RAO,Andhra Pradesh Rashtra Samithi,31,0,31,0.02,Guntur West,94,Andhra Pradesh 
1307,NEELAM PRASADARAO,Jaibhim Rao Bharat Party,28,0,28,0.01,Guntur West,94,Andhra Pradesh 
1308,BASHEER AHMED,Indian Union Muslim League,35,0,35,0.02,Guntur West,94,Andhra Pradesh 
1309,RAYAPUDI. PERCY RANI,Indian Labour Party (Ambedkar Phule),33,1,34,0.02,Guntur West,94,Andhra Pradesh 
1310,N. J. VIDYA SAGAR,Viduthalai Chiruthaigal Katchi,52,1,53,0.03,Guntur West,94,Andhra Pradesh 
1311,SATYAPRAMODA. UDUTA,Yuga Thulasi Party,87,3,90,0.05,Guntur West,94,Andhra Pradesh 
1312,SYED RIZVANA,Navarang Congress Party,50,0,50,0.03,Guntur West,94,Andhra Pradesh 
1313,DR. T. SEVAKUMAR (S.H.O SEVAKUMAR),Andhra Rastra Praja Samithi,244,11,255,0.14,Guntur West,94,Andhra Pradesh 
1314,KANAKA RATNAM GUNDU,Independent,290,0,290,0.15,Guntur West,94,Andhra Pradesh 
1315,KOTIKALA ANITHA,Independent,273,3,276,0.15,Guntur West,94,Andhra Pradesh 
1316,GANDIKOTA BALAJI,Independent,134,0,134,0.07,Guntur West,94,Andhra Pradesh 
1317,CHINTAPALLI VENKATA RAMAIAH,Independent,60,1,61,0.03,Guntur West,94,Andhra Pradesh 
1318,CHILLARA SUNITHA,Independent,26,0,26,0.01,Guntur West,94,Andhra Pradesh 
1319,PALLEBOYINA SWATHI,Independent,799,16,815,0.43,Guntur West,94,Andhra Pradesh 
1320,PALAKAYALA SRINIVAS RAO,Independent,16,0,16,0.01,Guntur West,94,Andhra Pradesh 
1321,MADHAVI TUMMURU,Independent,34,0,34,0.02,Guntur West,94,Andhra Pradesh 
1322,RACHA MALLIKARJUNA RAO,Independent,47,0,47,0.02,Guntur West,94,Andhra Pradesh 
1323,SIVA DURGA PRASANNA,Independent,22,0,22,0.01,Guntur West,94,Andhra Pradesh 
1324,SHAIK. MUNTAZ,Independent,47,0,47,0.02,Guntur West,94,Andhra Pradesh 
1325,SATTENAPALLI NARASIMHA RAO,Independent,26,0,26,0.01,Guntur West,94,Andhra Pradesh 
1326,NOTA,None of the Above,1020,35,1055,0.56,Guntur West,94,Andhra Pradesh 
1327,GUDAVALLI MANIKUMARI,Bahujan Samaj Party,989,7,996,0.55,Guntur East,95,Andhra Pradesh 
1328,NOORI FATHIMA SHAIK,Yuvajana Sramika Rythu Congress Party,67812,1041,68853,38.36,Guntur East,95,Andhra Pradesh 
1329,MOHAMMED NASEER AHMED,Telugu Desam,99163,1652,100815,56.17,Guntur East,95,Andhra Pradesh 
1330,SHAIK MASTAN VALI,Indian National Congress,5141,98,5239,2.92,Guntur East,95,Andhra Pradesh 
1331,ALTAF HUSSAIN SHAIK,Indian Union Muslim League,72,0,72,0.04,Guntur East,95,Andhra Pradesh 
1332,KAJA VENKATA RAGHAVENDRA SANJEEVARAO,Pyramid Party of India,101,1,102,0.06,Guntur East,95,Andhra Pradesh 
1333,NALLAKA VIJAYA RAJU,Navodayam Party,93,1,94,0.05,Guntur East,95,Andhra Pradesh 
1334,SHAIK ALTHAF,Andhra Pradesh Rashtra Samithi,82,0,82,0.05,Guntur East,95,Andhra Pradesh 
1335,SHAIK AHAMED BASHA,Navarang Congress Party,56,1,57,0.03,Guntur East,95,Andhra Pradesh 
1336,DURREY SHAHAWAR SHAIK,Independent,82,0,82,0.05,Guntur East,95,Andhra Pradesh 
1337,DR. VAHED,Independent,89,4,93,0.05,Guntur East,95,Andhra Pradesh 
1338,SHAIK SILAR,Independent,88,0,88,0.05,Guntur East,95,Andhra Pradesh 
1339,SYED JAVED,Independent,126,0,126,0.07,Guntur East,95,Andhra Pradesh 
1340,HAROON RASHEED SHAIK,Independent,1560,17,1577,0.88,Guntur East,95,Andhra Pradesh 
1341,NOTA,None of the Above,1197,18,1215,0.68,Guntur East,95,Andhra Pradesh 
1342,KAVATI SIVA NAGA MANOHAR NAIDU,Yuvajana Sramika Rythu Congress Party,77036,764,77800,39.82,Chilakaluripet,96,Andhra Pradesh 
1343,KOPPULA BABU RAO,Bahujan Samaj Party,455,9,464,0.24,Chilakaluripet,96,Andhra Pradesh 
1344,PRATHIPATI PULLARAO,Telugu Desam,109573,1489,111062,56.84,Chilakaluripet,96,Andhra Pradesh 
1345,MADDULA RADHA KRISHNA,Indian National Congress,2235,35,2270,1.16,Chilakaluripet,96,Andhra Pradesh 
1346,MUKIRI. RAMAKOTESWARA RAO,Indian Labour Party (Ambedkar Phule),61,0,61,0.03,Chilakaluripet,96,Andhra Pradesh 
1347,RATNA KUMARI. TANNIRU,Pyramid Party of India,97,0,97,0.05,Chilakaluripet,96,Andhra Pradesh 
1348,RAVU SUBRAHMANYAM,Navataram Party,414,4,418,0.21,Chilakaluripet,96,Andhra Pradesh 
1349,VINOD KUMAR DOPPALAPUDI,Bharatha Chaitanya Yuvajana Party,28,0,28,0.01,Chilakaluripet,96,Andhra Pradesh 
1350,SHAIK GOUSE BASHA,Rashtriya Jankranti Party,28,0,28,0.01,Chilakaluripet,96,Andhra Pradesh 
1351,KATTA KIRAN KUMAR,Independent,22,0,22,0.01,Chilakaluripet,96,Andhra Pradesh 
1352,KUMAR SIVARAM VINAY. T,Independent,27,0,27,0.01,Chilakaluripet,96,Andhra Pradesh 
1353,GOUTHAM KATA,Independent,38,1,39,0.02,Chilakaluripet,96,Andhra Pradesh 
1354,CHELLI. DAYARATHNAM,Independent,34,0,34,0.02,Chilakaluripet,96,Andhra Pradesh 
1355,TANUBODDI SUNDARARAMIREDDY,Independent,44,0,44,0.02,Chilakaluripet,96,Andhra Pradesh 
1356,THAMMULURI RAMANAIAH,Independent,67,0,67,0.03,Chilakaluripet,96,Andhra Pradesh 
1357,NALLAMOTHU. MADHAVA RAO,Independent,227,0,227,0.12,Chilakaluripet,96,Andhra Pradesh 
1358,PRATHIPATI PICHAIAH,Independent,1060,0,1060,0.54,Chilakaluripet,96,Andhra Pradesh 
1359,PRATHIPATI RAVI BABU,Independent,127,0,127,0.06,Chilakaluripet,96,Andhra Pradesh 
1360,BAHUJANKU RAJESH,Independent,296,0,296,0.15,Chilakaluripet,96,Andhra Pradesh 
1361,MANOHAR DAMARLA,Independent,227,0,227,0.12,Chilakaluripet,96,Andhra Pradesh 
1362,P RAHAMTHUN,Independent,57,0,57,0.03,Chilakaluripet,96,Andhra Pradesh 
1363,RAMI REDDY MARELLA,Independent,34,0,34,0.02,Chilakaluripet,96,Andhra Pradesh 
1364,VANTARI. VIJAYAMMA,Independent,28,0,28,0.01,Chilakaluripet,96,Andhra Pradesh 
1365,SAMBASIVARAO PONNEGANTI,Independent,39,0,39,0.02,Chilakaluripet,96,Andhra Pradesh 
1366,SAI GANESH KORNEPATI,Independent,53,3,56,0.03,Chilakaluripet,96,Andhra Pradesh 
1367,NOTA,None of the Above,774,14,788,0.4,Chilakaluripet,96,Andhra Pradesh 
1368,ARAVINDA BABU CHADALAVADA,Telugu Desam,101270,1897,103167,53.98,Narasaraopet,97,Andhra Pradesh 
1369,GOPIREDDY SRINIVASA REDDY,Yuvajana Sramika Rythu Congress Party,82271,1191,83462,43.67,Narasaraopet,97,Andhra Pradesh 
1370,BUDALA SAMELU,Bahujan Samaj Party,821,7,828,0.43,Narasaraopet,97,Andhra Pradesh 
1371,MAHABOOB BASHA SHAIK,Indian National Congress,1790,30,1820,0.95,Narasaraopet,97,Andhra Pradesh 
1372,GOGULA MANOHAR,Bharatha Chaitanya Yuvajana Party,118,1,119,0.06,Narasaraopet,97,Andhra Pradesh 
1373,GODA JOHN PAUL,Jaibhim Rao Bharat Party,181,1,182,0.1,Narasaraopet,97,Andhra Pradesh 
1374,DOCTOR GODA RAMESH KUMAR,Jatiya Jana Sena Party,66,0,66,0.03,Narasaraopet,97,Andhra Pradesh 
1375,TALLAPANENI HARI KRISHNA,Pyramid Party of India,34,0,34,0.02,Narasaraopet,97,Andhra Pradesh 
1376,ANIL KUMAR PATHRI,Independent,94,6,100,0.05,Narasaraopet,97,Andhra Pradesh 
1377,KUCHIPUDI CHANDRA SEKHAR,Independent,50,2,52,0.03,Narasaraopet,97,Andhra Pradesh 
1378,KOTI REDDY.KUMMETA,Independent,38,1,39,0.02,Narasaraopet,97,Andhra Pradesh 
1379,MAHAMMAD MANZOOR SHAIK.,Independent,47,0,47,0.02,Narasaraopet,97,Andhra Pradesh 
1380,SRIRAMINENI. PRASAD.,Independent,50,0,50,0.03,Narasaraopet,97,Andhra Pradesh 
1381,SHAIK . MOULALI,Independent,98,1,99,0.05,Narasaraopet,97,Andhra Pradesh 
1382,NOTA,None of the Above,1033,19,1052,0.55,Narasaraopet,97,Andhra Pradesh 
1383,AMBATI RAMBABU,Yuvajana Sramika Rythu Congress Party,89400,729,90129,42.4,Sattenapalle,98,Andhra Pradesh 
1384,KANNA LAKSHMINARAYANA,Telugu Desam,116798,1167,117965,55.5,Sattenapalle,98,Andhra Pradesh 
1385,CHUKKA CHANDRA PAUL,Indian National Congress,1548,32,1580,0.74,Sattenapalle,98,Andhra Pradesh 
1386,PERUPOGU NAVEEN BABU,Bahujan Samaj Party,641,6,647,0.3,Sattenapalle,98,Andhra Pradesh 
1387,GODA VENKATA RAMANA,Jatiya Jana Sena Party,117,2,119,0.06,Sattenapalle,98,Andhra Pradesh 
1388,JONNALAGADDA VIJAY KUMAR,Jaibhim Rao Bharat Party,164,6,170,0.08,Sattenapalle,98,Andhra Pradesh 
1389,YAMMOJI HANUMANTHA RAO,Yuga Thulasi Party,106,1,107,0.05,Sattenapalle,98,Andhra Pradesh 
1390,RANGISETTI NAGESWARA RAO,Pyramid Party of India,84,0,84,0.04,Sattenapalle,98,Andhra Pradesh 
1391,SHEK DARIYAVALI,Jai Bharat National Party,45,2,47,0.02,Sattenapalle,98,Andhra Pradesh 
1392,GADDAM RAMBABU,Independent,61,2,63,0.03,Sattenapalle,98,Andhra Pradesh 
1393,P. GOVINDA RAMESH BABU,Independent,28,0,28,0.01,Sattenapalle,98,Andhra Pradesh 
1394,JAKRIYA KANDUKURI,Independent,212,1,213,0.1,Sattenapalle,98,Andhra Pradesh 
1395,PADI MANIKANTA,Independent,108,0,108,0.05,Sattenapalle,98,Andhra Pradesh 
1396,MEKALA VENUMADHAVA REDDY,Independent,78,0,78,0.04,Sattenapalle,98,Andhra Pradesh 
1397,MEKALA SUBBARAO,Independent,90,0,90,0.04,Sattenapalle,98,Andhra Pradesh 
1398,NOTA,None of the Above,1126,14,1140,0.54,Sattenapalle,98,Andhra Pradesh 
1399,GONUGUNTLA VENKATA SIVA SITA RAMA ANZANNEYLLU,Telugu Desam,129813,1625,131438,55.06,Vinukonda,99,Andhra Pradesh 
1400,CHENNA SRINIVASA RAO,Indian National Congress,1890,12,1902,0.8,Vinukonda,99,Andhra Pradesh 
1401,BOLLA BRAHMA NAIDU,Yuvajana Sramika Rythu Congress Party,100130,1041,101171,42.38,Vinukonda,99,Andhra Pradesh 
1402,MASIPOGU YESOBU,Bahujan Samaj Party,1239,4,1243,0.52,Vinukonda,99,Andhra Pradesh 
1403,KUKATLAPALLI PRASAD,Jaathia Chethi Vruthula Ikya Vedika Party,126,0,126,0.05,Vinukonda,99,Andhra Pradesh 
1404,RAMANA GADDAM,Pyramid Party of India,226,0,226,0.09,Vinukonda,99,Andhra Pradesh 
1405,CHIRANJEEVI NAIK,Jai Bharat National Party,65,3,68,0.03,Vinukonda,99,Andhra Pradesh 
1406,USTALA CHINA KASAIAH,Independent,31,0,31,0.01,Vinukonda,99,Andhra Pradesh 
1407,BATCHU VENKATA RAVI KUMAR,Independent,43,1,44,0.02,Vinukonda,99,Andhra Pradesh 
1408,BOLLA VEERANJANEYULU,Independent,42,0,42,0.02,Vinukonda,99,Andhra Pradesh 
1409,MOLAKA SEETARAM,Independent,57,2,59,0.02,Vinukonda,99,Andhra Pradesh 
1410,SRINIVASA RAO NARALASETTY,Independent,334,1,335,0.14,Vinukonda,99,Andhra Pradesh 
1411,SRINIVASARAO JADDA,Independent,138,3,141,0.06,Vinukonda,99,Andhra Pradesh 
1412,SHAIK BAJI,Independent,176,1,177,0.07,Vinukonda,99,Andhra Pradesh 
1413,NOTA,None of the Above,1685,9,1694,0.71,Vinukonda,99,Andhra Pradesh 
1414,KASU MAHESH REDDY,Yuvajana Sramika Rythu Congress Party,97893,822,98715,42.36,Gurajala,100,Andhra Pradesh 
1415,NAGENDLA YOBU,Bahujan Samaj Party,906,3,909,0.39,Gurajala,100,Andhra Pradesh 
1416,YARAPATHINENI SRINIVASA RAO,Telugu Desam,126958,1243,128201,55.01,Gurajala,100,Andhra Pradesh 
1417,YALAMANDA REDDY TIYYAGURA,Indian National Congress,2137,19,2156,0.93,Gurajala,100,Andhra Pradesh 
1418,KANAKAM.SRINIVASARAO,National Nava Kranthi Party,159,0,159,0.07,Gurajala,100,Andhra Pradesh 
1419,JULURI RAMESH,Jaibhim Rao Bharat Party,120,0,120,0.05,Gurajala,100,Andhra Pradesh 
1420,SRINIVASARAO GADDAM,Andhra Rastra Praja Samithi,93,0,93,0.04,Gurajala,100,Andhra Pradesh 
1421,SRINIVASARAO NEERUMALLA,Akhil Bharatiya Jan Sangh,156,1,157,0.07,Gurajala,100,Andhra Pradesh 
1422,KOPPARAPU VENKATA PURUSHOTHAMARAO,Independent,91,0,91,0.04,Gurajala,100,Andhra Pradesh 
1423,GANGAVARAPU MALLAMMA,Independent,89,3,92,0.04,Gurajala,100,Andhra Pradesh 
1424,CHEDILA NAGARJUNA,Independent,87,0,87,0.04,Gurajala,100,Andhra Pradesh 
1425,BADAM VENKATESWARA REDDY,Independent,146,0,146,0.06,Gurajala,100,Andhra Pradesh 
1426,RAMA RAO KOYA,Independent,232,0,232,0.1,Gurajala,100,Andhra Pradesh 
1427,NOTA,None of the Above,1873,15,1888,0.81,Gurajala,100,Andhra Pradesh 
1428,GUNDALA SAIDULU,Bahujan Samaj Party,2421,6,2427,1.1,Macherla ,101,Andhra Pradesh 
1429,JULAKANTI BRAHMANANDA REDDY,Telugu Desam,121041,1372,122413,55.62,Macherla ,101,Andhra Pradesh 
1430,RAMAKRISHNAREDDY. PINNELLI,Yuvajana Sramika Rythu Congress Party,88122,973,89095,40.48,Macherla ,101,Andhra Pradesh 
1431,RAMACHANDRAREDDY YARAMALA,Indian National Congress,2221,16,2237,1.02,Macherla ,101,Andhra Pradesh 
1432,NAVULURI SHIVA REDDY,Jai Bharat National Party,213,1,214,0.1,Macherla ,101,Andhra Pradesh 
1433,BATCHU. VENKATESWARLU,Pyramid Party of India,328,1,329,0.15,Macherla ,101,Andhra Pradesh 
1434,YENUMULA KESAVA REDDY,Telugu Rajadhikara Samiti Party,104,1,105,0.05,Macherla ,101,Andhra Pradesh 
1435,KUNDURU VEERANJANEYAREDDY,Independent,101,0,101,0.05,Macherla ,101,Andhra Pradesh 
1436,KOTRA RAJESH,Independent,76,2,78,0.04,Macherla ,101,Andhra Pradesh 
1437,GUMMADI. KOTESWARARAO YADAV,Independent,83,2,85,0.04,Macherla ,101,Andhra Pradesh 
1438,GOLLA SRINIVASARAO,Independent,170,2,172,0.08,Macherla ,101,Andhra Pradesh 
1439,DEGALA SAIDARAJU,Independent,135,0,135,0.06,Macherla ,101,Andhra Pradesh 
1440,PRASAD SURA,Independent,148,0,148,0.07,Macherla ,101,Andhra Pradesh 
1441,VRS SATYANARAYANA CHARI MAROJU,Independent,527,1,528,0.24,Macherla ,101,Andhra Pradesh 
1442,SHAIK MABU JANI,Independent,286,0,286,0.13,Macherla ,101,Andhra Pradesh 
1443,NOTA,None of the Above,1728,18,1746,0.79,Macherla ,101,Andhra Pradesh 
1444,AJITHA RAO BUDALA,Indian National Congress,2166,26,2192,1.18,Yerragondapalem (SC),102,Andhra Pradesh 
1445,ERIXION BABU GUDURI,Telugu Desam,85487,1054,86541,46.6,Yerragondapalem (SC),102,Andhra Pradesh 
1446,KOTA PITCHAIAH,Bahujan Samaj Party,1327,3,1330,0.72,Yerragondapalem (SC),102,Andhra Pradesh 
1447,CHANDRA SEKHAR TATIPARTHI,Yuvajana Sramika Rythu Congress Party,90964,777,91741,49.4,Yerragondapalem (SC),102,Andhra Pradesh 
1448,KORRAPOLU JAYA RAO,Jatiya Jana Sena Party,325,2,327,0.18,Yerragondapalem (SC),102,Andhra Pradesh 
1449,CHEDURI VENKATESH,Navarang Congress Party,82,0,82,0.04,Yerragondapalem (SC),102,Andhra Pradesh 
1450,THELLA EBSHI RANI,Liberation Congress Party,81,1,82,0.04,Yerragondapalem (SC),102,Andhra Pradesh 
1451,DUPATI CHANDRA BABU,Jai Bharat National Party,137,1,138,0.07,Yerragondapalem (SC),102,Andhra Pradesh 
1452,MUTUKURI KRUPAIAH,Bharatha Chaitanya Yuvajana Party,161,3,164,0.09,Yerragondapalem (SC),102,Andhra Pradesh 
1453,VENKATESWARLU DARSI,Jaibhim Rao Bharat Party,119,0,119,0.06,Yerragondapalem (SC),102,Andhra Pradesh 
1454,VESAPOGU ELIA,Samajwadi Party,92,1,93,0.05,Yerragondapalem (SC),102,Andhra Pradesh 
1455,KOMMULA RAVI,Independent,147,1,148,0.08,Yerragondapalem (SC),102,Andhra Pradesh 
1456,THATHAPUDI JOHNSON,Independent,168,1,169,0.09,Yerragondapalem (SC),102,Andhra Pradesh 
1457,TURAKA RATNA PAUL,Independent,367,1,368,0.2,Yerragondapalem (SC),102,Andhra Pradesh 
1458,NOTA,None of the Above,2222,9,2231,1.2,Yerragondapalem (SC),102,Andhra Pradesh 
1459,ETTHADI SIVA PRASAD,Bahujan Samaj Party,556,5,561,0.27,Darsi,103,Andhra Pradesh 
1460,GOTTIPATI LAKSHMI,Telugu Desam,98330,1103,99433,48.01,Darsi,103,Andhra Pradesh 
1461,PUTLURI KONDA REDDY,Indian National Congress,1970,15,1985,0.96,Darsi,103,Andhra Pradesh 
1462,BUCHEPALLI SIVA PRASAD REDDY,Yuvajana Sramika Rythu Congress Party,100927,962,101889,49.2,Darsi,103,Andhra Pradesh 
1463,ARIGELA SRINIVASULU,Bharatha Chaitanya Yuvajana Party,302,3,305,0.15,Darsi,103,Andhra Pradesh 
1464,KUNCHALA KOTESWARARAO,Radical Party of India (Ambedkarist),102,0,102,0.05,Darsi,103,Andhra Pradesh 
1465,TENALI RAVIBABU,Andhra Rastra Praja Samithi,109,1,110,0.05,Darsi,103,Andhra Pradesh 
1466,TELUKUTLA KALYANA KUMAR,Samajwadi Party,114,0,114,0.06,Darsi,103,Andhra Pradesh 
1467,PATIBANDLA THRIPURADAS,Jatiya Jana Sena Party,94,0,94,0.05,Darsi,103,Andhra Pradesh 
1468,JOHN VESLY ANAPARTHI,Independent,136,0,136,0.07,Darsi,103,Andhra Pradesh 
1469,MANCHA MEENA,Independent,269,1,270,0.13,Darsi,103,Andhra Pradesh 
1470,NOTA,None of the Above,2098,9,2107,1.02,Darsi,103,Andhra Pradesh 
1471,YELURI SAMBASIVA RAO,Telugu Desam,108941,1634,110575,54.67, Parchur ,104,Andhra Pradesh 
1472,NALLAGORLA SIVA SRILAKSHMI JYOTHI,Indian National Congress,2275,18,2293,1.13, Parchur ,104,Andhra Pradesh 
1473,YADAM BALAJI,Yuvajana Sramika Rythu Congress Party,85571,991,86562,42.79, Parchur ,104,Andhra Pradesh 
1474,VENKATRATNAM THAMMULURI,Bahujan Samaj Party,401,2,403,0.2, Parchur ,104,Andhra Pradesh 
1475,YERIJARLA VIDYUL KUMAR,Radical Party of India (Ambedkarist),59,0,59,0.03, Parchur ,104,Andhra Pradesh 
1476,BACHINA RAMBABU,Jateeya Sama Samajam Party,419,8,427,0.21, Parchur ,104,Andhra Pradesh 
1477,BENDAPUDI LOKESHWARA SARMA,Pyramid Party of India,60,0,60,0.03, Parchur ,104,Andhra Pradesh 
1478,ALOKAM RAMESH BABU,Independent,23,0,23,0.01, Parchur ,104,Andhra Pradesh 
1479,KORAMBANDI SURESH BABU,Independent,19,1,20,0.01, Parchur ,104,Andhra Pradesh 
1480,GERA RAVINDRANADH TAGORE,Independent,27,0,27,0.01, Parchur ,104,Andhra Pradesh 
1481,GOVINDU KONDURI,Independent,21,2,23,0.01, Parchur ,104,Andhra Pradesh 
1482,CHIMPIRAIAH GALI,Independent,39,1,40,0.02, Parchur ,104,Andhra Pradesh 
1483,CHIMATA HANUMANTHARAO,Independent,76,2,78,0.04, Parchur ,104,Andhra Pradesh 
1484,P. SRINIVASA RAO,Independent,267,0,267,0.13, Parchur ,104,Andhra Pradesh 
1485,SHAIK KHASIM SAIDA,Independent,128,0,128,0.06, Parchur ,104,Andhra Pradesh 
1486,NOTA,None of the Above,1269,20,1289,0.64, Parchur ,104,Andhra Pradesh 
1487,AMANCHI KRISHNA MOHAN,Indian National Congress,41295,564,41859,24.58,Chirala,106,Andhra Pradesh 
1488,KARANAM VENKATESH,Yuvajana Sramika Rythu Congress Party,50802,914,51716,30.36,Chirala,106,Andhra Pradesh 
1489,KATI MARK,Bahujan Samaj Party,1026,13,1039,0.61,Chirala,106,Andhra Pradesh 
1490,MADDULURI MALA KONDAIAH,Telugu Desam,71360,1340,72700,42.68,Chirala,106,Andhra Pradesh 
1491,ABDUL BASHEER SHAIK,Indian Union Muslim League,211,1,212,0.12,Chirala,106,Andhra Pradesh 
1492,ANKAMMA GANDHI LAGADAPATI,Pyramid Party of India,152,2,154,0.09,Chirala,106,Andhra Pradesh 
1493,THANNEERU VIJAY,Reforms Party of India,126,0,126,0.07,Chirala,106,Andhra Pradesh 
1494,RAVI KUMAR SEELAM,Liberation Congress Party,61,2,63,0.04,Chirala,106,Andhra Pradesh 
1495,VENKATESWARLU SEELAM,Jaathia Chethi Vruthula Ikya Vedika Party,53,0,53,0.03,Chirala,106,Andhra Pradesh 
1496,ASADI ANJANEYULU,Independent,108,2,110,0.06,Chirala,106,Andhra Pradesh 
1497,TELLA RAMBABU,Independent,51,1,52,0.03,Chirala,106,Andhra Pradesh 
1498,PATTAN KALESHA,Independent,39,1,40,0.02,Chirala,106,Andhra Pradesh 
1499,PINJALA SANTHARAM,Independent,97,1,98,0.06,Chirala,106,Andhra Pradesh 
1500,RAVINDRA BABU PAVULURI,Independent,113,0,113,0.07,Chirala,106,Andhra Pradesh 
1501,SRINIVASA RAO POLISETTY,Independent,732,6,738,0.43,Chirala,106,Andhra Pradesh 
1502,NOTA,None of the Above,1238,17,1255,0.74,Chirala,106,Andhra Pradesh 
1503,KAILA VENKATARAO,Bahujan Samaj Party,3223,7,3230,1.7,Santhanuthalapadu,107,Andhra Pradesh 
1504,NAGARJUNA MERUGU,Yuvajana Sramika Rythu Congress Party,74652,720,75372,39.69,Santhanuthalapadu,107,Andhra Pradesh 
1505,PALAPARTHI VIJESH RAJ,Indian National Congress,2693,22,2715,1.43,Santhanuthalapadu,107,Andhra Pradesh 
1506,VIJAY KUMAR B.N,Telugu Desam,104326,1431,105757,55.69,Santhanuthalapadu,107,Andhra Pradesh 
1507,ESTHARLA SANKARAIAH,Liberation Congress Party,243,1,244,0.13,Santhanuthalapadu,107,Andhra Pradesh 
1508,KATUKURI DAVID,Jaibhim Rao Bharat Party,110,1,111,0.06,Santhanuthalapadu,107,Andhra Pradesh 
1509,CHAVABATHINA RAMBABU,Radical Party of India (Ambedkarist),60,0,60,0.03,Santhanuthalapadu,107,Andhra Pradesh 
1510,TALLURI NAGARAJU,Pyramid Party of India,64,0,64,0.03,Santhanuthalapadu,107,Andhra Pradesh 
1511,PANTHAGANI VIJAYABABU,Jatiya Jana Sena Party,79,1,80,0.04,Santhanuthalapadu,107,Andhra Pradesh 
1512,KATTI RATNAKUMARI,Independent,51,0,51,0.03,Santhanuthalapadu,107,Andhra Pradesh 
1513,KOTI RAVIKUMAR,Independent,54,1,55,0.03,Santhanuthalapadu,107,Andhra Pradesh 
1514,GATTUPALLI GOPALA RAO,Independent,138,2,140,0.07,Santhanuthalapadu,107,Andhra Pradesh 
1515,MANDA SARATH BABU,Independent,131,1,132,0.07,Santhanuthalapadu,107,Andhra Pradesh 
1516,VADDIMUKKALA RAVEENDRABABU,Independent,180,0,180,0.09,Santhanuthalapadu,107,Andhra Pradesh 
1517,NOTA,None of the Above,1710,15,1725,0.91,Santhanuthalapadu,107,Andhra Pradesh 
1518,THATIPARTHI.VENKATA SWAMY,Bahujan Samaj Party,259,15,274,0.13,Ongole,108,Andhra Pradesh 
1519,TURAKAPALLI NAGALAKSHMI,Indian National Congress,2018,49,2067,0.99,Ongole,108,Andhra Pradesh 
1520,DAMACHARLA JANARDHANA RAO,Telugu Desam,115908,2892,118800,56.76,Ongole,108,Andhra Pradesh 
1521,BALINENI SRINIVASA REDDY,Yuvajana Sramika Rythu Congress Party,82794,1980,84774,40.5,Ongole,108,Andhra Pradesh 
1522,KOLA SATISH,Navarang Congress Party,226,0,226,0.11,Ongole,108,Andhra Pradesh 
1523,BRAHMA NAIDU BILLA,Radical Party of India (Ambedkarist),75,0,75,0.04,Ongole,108,Andhra Pradesh 
1524,MITNASALA CHAITANYA PRASADU,Liberation Congress Party,60,0,60,0.03,Ongole,108,Andhra Pradesh 
1525,A.YOGANAND,Pyramid Party of India,71,1,72,0.03,Ongole,108,Andhra Pradesh 
1526,VALLAMREDDY.RAJAGOPALA REDDY,Jai Bharat National Party,63,0,63,0.03,Ongole,108,Andhra Pradesh 
1527,AKKARAJU NIRMAL,Independent,47,0,47,0.02,Ongole,108,Andhra Pradesh 
1528,ANITHA PALETI,Independent,49,0,49,0.02,Ongole,108,Andhra Pradesh 
1529,ALA.NARAYANA RAO,Independent,39,0,39,0.02,Ongole,108,Andhra Pradesh 
1530,ASODHI SANKAR REDDY,Independent,89,0,89,0.04,Ongole,108,Andhra Pradesh 
1531,CHAPPIDI.RAVI BABU,Independent,64,0,64,0.03,Ongole,108,Andhra Pradesh 
1532,TIRUPATISWAMI,Independent,51,0,51,0.02,Ongole,108,Andhra Pradesh 
1533,THELLA.KIRAN KUMAR,Independent,168,0,168,0.08,Ongole,108,Andhra Pradesh 
1534,DASARI SUNDARAM,Independent,126,0,126,0.06,Ongole,108,Andhra Pradesh 
1535,PATAPANJULA SRINU,Independent,120,0,120,0.06,Ongole,108,Andhra Pradesh 
1536,PATAPATI SRINIVASARAO,Independent,223,0,223,0.11,Ongole,108,Andhra Pradesh 
1537,MANNAM.SUDHEER KUMAR,Independent,282,3,285,0.14,Ongole,108,Andhra Pradesh 
1538,MANDAPALLI VENKATESWARLU,Independent,65,2,67,0.03,Ongole,108,Andhra Pradesh 
1539,SHAIK MUNTHAJ,Independent,66,1,67,0.03,Ongole,108,Andhra Pradesh 
1540,VAJRALA.MAHESWAR REDDY,Independent,47,0,47,0.02,Ongole,108,Andhra Pradesh 
1541,VENKATA RAO KOLLA,Independent,37,0,37,0.02,Ongole,108,Andhra Pradesh 
1542,SUNKARA.KALYANI,Independent,47,2,49,0.02,Ongole,108,Andhra Pradesh 
1543,HUSSAIN BEE.SHAIK,Independent,53,1,54,0.03,Ongole,108,Andhra Pradesh 
1544,NOTA,None of the Above,1282,28,1310,0.63,Ongole,108,Andhra Pradesh 
1545,INTURI NAGESWARA RAO,Telugu Desam,107546,1627,109173,52.8, Kandukur,109,Andhra Pradesh 
1546,GOUSE MOHIDDIN SYED,Indian National Congress,2281,19,2300,1.11, Kandukur,109,Andhra Pradesh 
1547,MADHU SUDHANRAO BURRA,Yuvajana Sramika Rythu Congress Party,89733,882,90615,43.82, Kandukur,109,Andhra Pradesh 
1548,SATYANARAYANA PERAM,Bahujan Samaj Party,854,14,868,0.42, Kandukur,109,Andhra Pradesh 
1549,YENDLURI BALAKUMAR,Radical Party of India (Ambedkarist),108,1,109,0.05, Kandukur,109,Andhra Pradesh 
1550,GOLI PADMAJA,Liberation Congress Party,65,3,68,0.03, Kandukur,109,Andhra Pradesh 
1551,CHEKURI VENKATA KRISHNA RAO,Pyramid Party of India,75,2,77,0.04, Kandukur,109,Andhra Pradesh 
1552,JAGANADHAM SRINU,Neethi Nijayithi Party,47,0,47,0.02, Kandukur,109,Andhra Pradesh 
1553,PODAPATI SIVA KUMAR,Jai Bharat National Party,98,4,102,0.05, Kandukur,109,Andhra Pradesh 
1554,AKKILAGUNTA ESHAK,Independent,65,0,65,0.03, Kandukur,109,Andhra Pradesh 
1555,UNNAM RADHAMMA,Independent,60,0,60,0.03, Kandukur,109,Andhra Pradesh 
1556,GODUGU MALYADRI,Independent,73,0,73,0.04, Kandukur,109,Andhra Pradesh 
1557,CHALLA VENKATA MURALI KRISHNA,Independent,122,1,123,0.06, Kandukur,109,Andhra Pradesh 
1558,CHENNIBOINA NARASIMHAM,Independent,97,1,98,0.05, Kandukur,109,Andhra Pradesh 
1559,CHERUKURI JASHUVA,Independent,167,0,167,0.08, Kandukur,109,Andhra Pradesh 
1560,TATIKONDA RAMBABU,Independent,374,0,374,0.18, Kandukur,109,Andhra Pradesh 
1561,NETHI MAHESWARA RAO,Independent,492,1,493,0.24, Kandukur,109,Andhra Pradesh 
1562,PODAPATI HARIBABU,Independent,235,0,235,0.11, Kandukur,109,Andhra Pradesh 
1563,MUCHU SRINIVASULU,Independent,435,1,436,0.21, Kandukur,109,Andhra Pradesh 
1564,RATHIKRINDI VENU,Independent,119,0,119,0.06, Kandukur,109,Andhra Pradesh 
1565,SYED NASEEMA,Independent,73,0,73,0.04, Kandukur,109,Andhra Pradesh 
1566,SANGA SATYANARAYANA,Independent,73,0,73,0.04, Kandukur,109,Andhra Pradesh 
1567,NOTA,None of the Above,1010,15,1025,0.5, Kandukur,109,Andhra Pradesh 
1568,AUDIMULAPU SURESH,Yuvajana Sramika Rythu Congress Party,91178,740,91918,42.96,Kondapi,110,Andhra Pradesh 
1569,DOCTOR DOLA SREE BALA VEERANJANEYA SWAMY,Telugu Desam,115310,1364,116674,54.53,Kondapi,110,Andhra Pradesh 
1570,SUDHAKARA RAO PASUMARTHI,Indian National Congress,1652,14,1666,0.78,Kondapi,110,Andhra Pradesh 
1571,RAVINUTALA MATRIKA,Bahujan Samaj Party,714,14,728,0.34,Kondapi,110,Andhra Pradesh 
1572,KONDALA RAO AMBATI,Viduthalai Chiruthaigal Katchi,187,3,190,0.09,Kondapi,110,Andhra Pradesh 
1573,KANAPARTHI SIVARAM,Liberation Congress Party,67,3,70,0.03,Kondapi,110,Andhra Pradesh 
1574,VANGEPURAM KASIRAJU,Samajwadi Party,55,0,55,0.03,Kondapi,110,Andhra Pradesh 
1575,KANDIPATI VENKATA KRISHNA RAO,Jaibhim Rao Bharat Party,104,0,104,0.05,Kondapi,110,Andhra Pradesh 
1576,SRIKANTH CHOPPARA,Navarang Congress Party,109,0,109,0.05,Kondapi,110,Andhra Pradesh 
1577,MENDA BALAKOTAIAH,Pyramid Party of India,90,1,91,0.04,Kondapi,110,Andhra Pradesh 
1578,RAVURI LAKSMANARAO,Radical Party of India (Ambedkarist),109,6,115,0.05,Kondapi,110,Andhra Pradesh 
1579,JAMULLAMUDI POLAIAH,Independent,124,0,124,0.06,Kondapi,110,Andhra Pradesh 
1580,SRINIVASARAO BODDU,Independent,112,0,112,0.05,Kondapi,110,Andhra Pradesh 
1581,MAMIDI MAALYADRI,Independent,127,0,127,0.06,Kondapi,110,Andhra Pradesh 
1582,SUJATHA VIGHNAM,Independent,249,0,249,0.12,Kondapi,110,Andhra Pradesh 
1583,NOTA,None of the Above,1600,12,1612,0.75,Kondapi,110,Andhra Pradesh 
1584,ANNA RAMBABU,Yuvajana Sramika Rythu Congress Party,83948,1078,85026,44.53,Markapuram,111,Andhra Pradesh 
1585,KANDULA NARAYANA REDDY,Telugu Desam,97365,1640,99005,51.85,Markapuram,111,Andhra Pradesh 
1586,SYED JAVEED ANWAR,Indian National Congress,2057,31,2088,1.09,Markapuram,111,Andhra Pradesh 
1587,CHATARAJUPALLI CHANDRASEKHAR,Jaibhim Rao Bharat Party,285,0,285,0.15,Markapuram,111,Andhra Pradesh 
1588,U. NARAYANA REDDY S/O BALIREDDY,Navarang Congress Party,88,0,88,0.05,Markapuram,111,Andhra Pradesh 
1589,NARAYANA REDDY S/O VENKATA NARAYANA REDDY,Jatiya Jana Sena Party,65,1,66,0.03,Markapuram,111,Andhra Pradesh 
1590,NUTALAPATI RAJU,Viduthalai Chiruthaigal Katchi,83,0,83,0.04,Markapuram,111,Andhra Pradesh 
1591,RAVILLA BHAGYALAKSHMI,Bharatha Chaitanya Yuvajana Party,66,1,67,0.04,Markapuram,111,Andhra Pradesh 
1592,SYED ISMAIL,Indian Union Muslim League,77,0,77,0.04,Markapuram,111,Andhra Pradesh 
1593,ABDUL RAWOOF,Independent,41,0,41,0.02,Markapuram,111,Andhra Pradesh 
1594,KANDI NARAYANA REDDY,Independent,56,0,56,0.03,Markapuram,111,Andhra Pradesh 
1595,KANUBUDDI RAMGOPAL REDDY,Independent,71,1,72,0.04,Markapuram,111,Andhra Pradesh 
1596,KUNDURU VISHNUVARDHAN REDDY,Independent,88,0,88,0.05,Markapuram,111,Andhra Pradesh 
1597,KUKUTLAPALLI ABBANNA,Independent,69,0,69,0.04,Markapuram,111,Andhra Pradesh 
1598,KOTTAPULI BRAHMAREDDY,Independent,128,0,128,0.07,Markapuram,111,Andhra Pradesh 
1599,GAYAM VENKATA REDDY,Independent,347,0,347,0.18,Markapuram,111,Andhra Pradesh 
1600,THAVANAM MAHESWARA REDDY,Independent,414,0,414,0.22,Markapuram,111,Andhra Pradesh 
1601,DEVIREDDY HANUMAREDDY,Independent,436,0,436,0.23,Markapuram,111,Andhra Pradesh 
1602,DONDAPATI SRINIVASA REDDY,Independent,134,0,134,0.07,Markapuram,111,Andhra Pradesh 
1603,NAGARJUNA REDDY YERUVA,Independent,306,1,307,0.16,Markapuram,111,Andhra Pradesh 
1604,PATHAN SUBHANI,Independent,330,3,333,0.17,Markapuram,111,Andhra Pradesh 
1605,POTTI VENKATA SUBBA RAO,Independent,143,0,143,0.07,Markapuram,111,Andhra Pradesh 
1606,BARIGE BALAIAH,Independent,31,1,32,0.02,Markapuram,111,Andhra Pradesh 
1607,BHAVANAM VENKATESWARA REDDY,Independent,32,0,32,0.02,Markapuram,111,Andhra Pradesh 
1608,P. BHANU PRASAD,Independent,24,1,25,0.01,Markapuram,111,Andhra Pradesh 
1609,IRRE BALA MADDILETI,Independent,39,0,39,0.02,Markapuram,111,Andhra Pradesh 
1610,YUDDAM NARASIMHARAO,Independent,122,0,122,0.06,Markapuram,111,Andhra Pradesh 
1611,NOTA,None of the Above,1308,19,1327,0.7,Markapuram,111,Andhra Pradesh 
1612,ASHOK REDDY MUTHUMULA,Telugu Desam,95608,2855,98463,47.6,Giddalur,112,Andhra Pradesh 
1613,ISUKALA JAYARAJU,Bahujan Samaj Party,1460,27,1487,0.72,Giddalur,112,Andhra Pradesh 
1614,KUNDURU NAGARJUNA REDDY (KP),Yuvajana Sramika Rythu Congress Party,96000,1490,97490,47.13,Giddalur,112,Andhra Pradesh 
1615,PAGADALA PEDDA RANGASWAMI,Indian National Congress,2759,120,2879,1.39,Giddalur,112,Andhra Pradesh 
1616,CHINTA SHAMSON,Telugu Rajadhikara Samiti Party,237,4,241,0.12,Giddalur,112,Andhra Pradesh 
1617,JAVVAJI PAVAN KUMAR,Pyramid Party of India,336,5,341,0.16,Giddalur,112,Andhra Pradesh 
1618,JANAVATH TAGORE NAIK,Liberation Congress Party,129,1,130,0.06,Giddalur,112,Andhra Pradesh 
1619,DASARI BABU RAO,Jaibhim Rao Bharat Party,156,4,160,0.08,Giddalur,112,Andhra Pradesh 
1620,KOPPULA NARASIMHULU,Independent,115,6,121,0.06,Giddalur,112,Andhra Pradesh 
1621,THAMIDALA KOTESWARA REDDY,Independent,77,0,77,0.04,Giddalur,112,Andhra Pradesh 
1622,PARISINENI VENKATESWARLU,Independent,572,5,577,0.28,Giddalur,112,Andhra Pradesh 
1623,PIDATALA RAMESH REDDY,Independent,110,3,113,0.05,Giddalur,112,Andhra Pradesh 
1624,BATTAPOTHULA OBULESU,Independent,165,3,168,0.08,Giddalur,112,Andhra Pradesh 
1625,BALASANI MALYADRI REDDY,Independent,176,2,178,0.09,Giddalur,112,Andhra Pradesh 
1626,BONTHA RANGA REDDY,Independent,149,1,150,0.07,Giddalur,112,Andhra Pradesh 
1627,BORRA RAGHAVENDRA YADAV,Independent,507,3,510,0.25,Giddalur,112,Andhra Pradesh 
1628,MEENIGE MURALI MOHAN REDDY,Independent,611,0,611,0.3,Giddalur,112,Andhra Pradesh 
1629,MUDIAM VENKATA RAMI REDDY,Independent,262,1,263,0.13,Giddalur,112,Andhra Pradesh 
1630,M.LAKSHMI RAMA NAIK,Independent,368,1,369,0.18,Giddalur,112,Andhra Pradesh 
1631,VARIKUNTLA PRASAD,Independent,149,1,150,0.07,Giddalur,112,Andhra Pradesh 
1632,VEERAMREDDY USHA RANI,Independent,135,5,140,0.07,Giddalur,112,Andhra Pradesh 
1633,NOTA,None of the Above,2233,18,2251,1.09,Giddalur,112,Andhra Pradesh 
1634,DR. UGRA NARASIMHA REDDY MUKKU,Telugu Desam,105303,1742,107045,51.93,Kanigiri,113,Andhra Pradesh 
1635,THATHAPUDI PRABHUDAS,Bahujan Samaj Party,1312,5,1317,0.64,Kanigiri,113,Andhra Pradesh 
1636,DADDALA NARAYANA,Yuvajana Sramika Rythu Congress Party,91518,923,92441,44.84,Kanigiri,113,Andhra Pradesh 
1637,DEVARAPALLI SUBBA REDDY,Indian National Congress,1820,18,1838,0.89,Kanigiri,113,Andhra Pradesh 
1638,ALLABAKSH SHAIK,Indian Union Muslim League,157,0,157,0.08,Kanigiri,113,Andhra Pradesh 
1639,DAMMU VENKATESH,Liberation Congress Party,119,1,120,0.06,Kanigiri,113,Andhra Pradesh 
1640,PANDITI ALLURAIAH,Pyramid Party of India,229,1,230,0.11,Kanigiri,113,Andhra Pradesh 
1641,SHAIK NAZIR BASHA,Samajwadi Party,124,0,124,0.06,Kanigiri,113,Andhra Pradesh 
1642,K KURSHEED,Independent,119,2,121,0.06,Kanigiri,113,Andhra Pradesh 
1643,SHAIK MASTAN VALI,Independent,105,0,105,0.05,Kanigiri,113,Andhra Pradesh 
1644,SHAIK SUBHAHAN,Independent,169,1,170,0.08,Kanigiri,113,Andhra Pradesh 
1645,SHAMSHIRA BHASHA MUPARLAPATI,Independent,262,0,262,0.13,Kanigiri,113,Andhra Pradesh 
1646,NOTA,None of the Above,2205,12,2217,1.08,Kanigiri,113,Andhra Pradesh 
1647,GUNJI VENKATESWARLU,Bahujan Samaj Party,616,14,630,0.32,Kavali,114,Andhra Pradesh 
1648,DAGUMATI VENKATA KRISHNA REDDY,Telugu Desam,104271,2265,106536,53.27,Kavali,114,Andhra Pradesh 
1649,PODALAKURI KALYAN,Indian National Congress,2309,31,2340,1.17,Kavali,114,Andhra Pradesh 
1650,RAMIREDDY PRATAP KUMAR REDDY,Yuvajana Sramika Rythu Congress Party,74520,1068,75588,37.8,Kavali,114,Andhra Pradesh 
1651,MUPPASANI NARENDRA,Jai Bharat National Party,315,1,316,0.16,Kavali,114,Andhra Pradesh 
1652,YELLU SALMAN,Radical Party of India (Ambedkarist),217,1,218,0.11,Kavali,114,Andhra Pradesh 
1653,SABBELLA VIJAYA BHASKARA REDDY,Pyramid Party of India,144,1,145,0.07,Kavali,114,Andhra Pradesh 
1654,ANUMALASETTY HARI PRASADA RAO,Independent,153,0,153,0.08,Kavali,114,Andhra Pradesh 
1655,GARRE SURESH BABU,Independent,217,0,217,0.11,Kavali,114,Andhra Pradesh 
1656,DEVARAPALLE KRISHNAREDDI,Independent,223,2,225,0.11,Kavali,114,Andhra Pradesh 
1657,PASUPULETI SUDHAKAR,Independent,10936,175,11111,5.56,Kavali,114,Andhra Pradesh 
1658,VAYILA TIRAPATHI,Independent,147,0,147,0.07,Kavali,114,Andhra Pradesh 
1659,VIDAVALAPATI SREENIVASULU,Independent,326,0,326,0.16,Kavali,114,Andhra Pradesh 
1660,NOTA,None of the Above,2008,22,2030,1.02,Kavali,114,Andhra Pradesh 
1661,ANAM.RAMANARAYANA REDDY,Telugu Desam,89243,1922,91165,49.85,Atmakur,115,Andhra Pradesh 
1662,CHEVURU SREEDHARA REDDY,Indian National Congress,2888,27,2915,1.59,Atmakur,115,Andhra Pradesh 
1663,THOGATHARI KRISHNA,Bahujan Samaj Party,1033,18,1051,0.57,Atmakur,115,Andhra Pradesh 
1664,MEKAPATI VIKRAM REDDY,Yuvajana Sramika Rythu Congress Party,82505,1084,83589,45.7,Atmakur,115,Andhra Pradesh 
1665,NELLORE.KRISHNA REDDY,Yuga Thulasi Party,455,0,455,0.25,Atmakur,115,Andhra Pradesh 
1666,BELLAMKONDA VENKATESH,Vishwa Jana Party,102,1,103,0.06,Atmakur,115,Andhra Pradesh 
1667,BODDU RAJESWARI,Pyramid Party of India,55,3,58,0.03,Atmakur,115,Andhra Pradesh 
1668,RAMANARAYANA REDDY NAGA SAI,Jatiya Jana Sena Party,56,0,56,0.03,Atmakur,115,Andhra Pradesh 
1669,RAMISETTY VENKATESWARLU,Samajwadi Party,82,2,84,0.05,Atmakur,115,Andhra Pradesh 
1670,SYED SHUKKUR,Indian Union Muslim League,120,0,120,0.07,Atmakur,115,Andhra Pradesh 
1671,GANGINENI SRINIVASULU,Independent,181,1,182,0.1,Atmakur,115,Andhra Pradesh 
1672,NAGELLA VENKATA BHANU PRAKASH,Independent,164,1,165,0.09,Atmakur,115,Andhra Pradesh 
1673,RAMNARAYANA REDDY DHANIREDDY,Independent,599,4,603,0.33,Atmakur,115,Andhra Pradesh 
1674,NOTA,None of the Above,2336,11,2347,1.28,Atmakur,115,Andhra Pradesh 
1675,ANIL KADIMPATI,Bahujan Samaj Party,813,24,837,0.39,Kovur,116,Andhra Pradesh 
1676,KIRAN KUMAR REDDY NARAPAREDDY,Indian National Congress,3172,31,3203,1.49,Kovur,116,Andhra Pradesh 
1677,NALLAPAREDDY PRASANNA KUMAR REDDY,Yuvajana Sramika Rythu Congress Party,75266,774,76040,35.33,Kovur,116,Andhra Pradesh 
1678,PRASHANTHI REDDY VEMIREDDY,Telugu Desam,128303,2320,130623,60.68,Kovur,116,Andhra Pradesh 
1679,ALLA SIVAIAH,Jaibhim Rao Bharat Party,307,0,307,0.14,Kovur,116,Andhra Pradesh 
1680,POLAVARAPU SUNANDA,Jai Maha Bharath Party,202,0,202,0.09,Kovur,116,Andhra Pradesh 
1681,RAGHURAM PANDHI,Loktantrik Janta Dal,97,0,97,0.05,Kovur,116,Andhra Pradesh 
1682,RAMISETTY SAI,Radical Party of India (Ambedkarist),76,0,76,0.04,Kovur,116,Andhra Pradesh 
1683,SOMA GOPAL,Bharatha Chaitanya Yuvajana Party,119,2,121,0.06,Kovur,116,Andhra Pradesh 
1684,UJWAL KUMAR KANDIKATTU,Independent,113,0,113,0.05,Kovur,116,Andhra Pradesh 
1685,CHAKKIRALA ANITHAMMA,Independent,184,0,184,0.09,Kovur,116,Andhra Pradesh 
1686,MODEM SREENIVASULU REDDY,Independent,175,0,175,0.08,Kovur,116,Andhra Pradesh 
1687,SHAIK CHOTE SAHEB,Independent,896,3,899,0.42,Kovur,116,Andhra Pradesh 
1688,NOTA,None of the Above,2361,16,2377,1.1,Kovur,116,Andhra Pradesh 
1689,KHALEEL AHAMAD MD,Yuvajana Sramika Rythu Congress Party,47613,449,48062,27.51,Nellore City,117,Andhra Pradesh 
1690,CHALLA SARATH KUMAR,Bahujan Samaj Party,1267,10,1277,0.73,Nellore City,117,Andhra Pradesh 
1691,NARAYANA PONGURU,Telugu Desam,118126,2425,120551,68.99,Nellore City,117,Andhra Pradesh 
1692,MULAM. RAMESH,Communist Party of India (Marxist),1986,52,2038,1.17,Nellore City,117,Andhra Pradesh 
1693,AMEER AHMED SHAIK,Social Democratic Party Of India,1050,10,1060,0.61,Nellore City,117,Andhra Pradesh 
1694,KALAHASTI CHENCHU MAHESH,Bharatha Chaitanya Yuvajana Party,119,0,119,0.07,Nellore City,117,Andhra Pradesh 
1695,PONNAPUDI SYAMALA,Pyramid Party of India,91,0,91,0.05,Nellore City,117,Andhra Pradesh 
1696,RAGUNATH RAMISETTY,Jaibhim Rao Bharat Party,67,0,67,0.04,Nellore City,117,Andhra Pradesh 
1697,D. SUNEEL KUMAR,Radical Party of India (Ambedkarist),22,1,23,0.01,Nellore City,117,Andhra Pradesh 
1698,GUNDALA PADMA REDDY,Independent,39,0,39,0.02,Nellore City,117,Andhra Pradesh 
1699,DASARI GOWTHAM,Independent,50,3,53,0.03,Nellore City,117,Andhra Pradesh 
1700,NARU. RAVI KUMAR REDDY,Independent,48,0,48,0.03,Nellore City,117,Andhra Pradesh 
1701,BANDARU VENKATA SRIDHAR,Independent,82,0,82,0.05,Nellore City,117,Andhra Pradesh 
1702,VELURU. RANGA RAO,Independent,118,0,118,0.07,Nellore City,117,Andhra Pradesh 
1703,HANUMANTHA RAO DESAISETTY,Independent,143,0,143,0.08,Nellore City,117,Andhra Pradesh 
1704,NOTA,None of the Above,944,23,967,0.55,Nellore City,117,Andhra Pradesh 
1705,ADALA PRABHAKARA REDDY,Yuvajana Sramika Rythu Congress Party,74275,1220,75495,38.81,Nellore Rural,118,Andhra Pradesh 
1706,KOTAMREDDY SRIDHAR REDDY,Telugu Desam,106587,3388,109975,56.53,Nellore Rural,118,Andhra Pradesh 
1707,BODEDDULA SRIRAMULU,Bahujan Samaj Party,655,29,684,0.35,Nellore Rural,118,Andhra Pradesh 
1708,SHAIK FAYAZ,Indian National Congress,4207,73,4280,2.2,Nellore Rural,118,Andhra Pradesh 
1709,ANIL KUMAR SURISETTY,Revolutionary Socialist Party,590,2,592,0.3,Nellore Rural,118,Andhra Pradesh 
1710,KATTA SIREESH,Akhil Bharatiya Jan Sangh,98,2,100,0.05,Nellore Rural,118,Andhra Pradesh 
1711,FAZIL SYED,Social Democratic Party Of India,946,11,957,0.49,Nellore Rural,118,Andhra Pradesh 
1712,JADDA NIRANJAN,Independent,46,0,46,0.02,Nellore Rural,118,Andhra Pradesh 
1713,BOMMALATA SURESH,Independent,74,1,75,0.04,Nellore Rural,118,Andhra Pradesh 
1714,SHAIK MUJEEB,Independent,152,3,155,0.08,Nellore Rural,118,Andhra Pradesh 
1715,SHAIK SARDAR HUSSIEN,Independent,167,0,167,0.09,Nellore Rural,118,Andhra Pradesh 
1716,NOTA,None of the Above,1972,44,2016,1.04,Nellore Rural,118,Andhra Pradesh 
1717,KAKANI GOVARDHAN REDDY,Yuvajana Sramika Rythu Congress Party,86249,741,86990,44.45,Sarvepalli,119,Andhra Pradesh 
1718,CHANDRA MOHAN REDDY SOMIREDDY,Telugu Desam,102243,1035,103278,52.77,Sarvepalli,119,Andhra Pradesh 
1719,CHANDRASEKHAR POOLA,Indian National Congress,1570,7,1577,0.81,Sarvepalli,119,Andhra Pradesh 
1720,JANAKI PRASAD,Bahujan Samaj Party,565,9,574,0.29,Sarvepalli,119,Andhra Pradesh 
1721,KURAPATI VIJAYA BABU,Young Senior Rich Common People Kings Party,148,0,148,0.08,Sarvepalli,119,Andhra Pradesh 
1722,NAKKA MANOHAR,Jatiya Jana Sena Party,80,0,80,0.04,Sarvepalli,119,Andhra Pradesh 
1723,PINISETTY SRIHARI,Pyramid Party of India,153,0,153,0.08,Sarvepalli,119,Andhra Pradesh 
1724,KADIVETI VENKAIAH,Independent,55,0,55,0.03,Sarvepalli,119,Andhra Pradesh 
1725,KOSURU NARAYANA,Independent,120,2,122,0.06,Sarvepalli,119,Andhra Pradesh 
1726,GOLLAMURI RAVI,Independent,76,2,78,0.04,Sarvepalli,119,Andhra Pradesh 
1727,TATIPARTHI VENU,Independent,66,0,66,0.03,Sarvepalli,119,Andhra Pradesh 
1728,BHASKAR THIGALA,Independent,93,0,93,0.05,Sarvepalli,119,Andhra Pradesh 
1729,MANNEM PEDDA PUTTAIAH,Independent,443,2,445,0.23,Sarvepalli,119,Andhra Pradesh 
1730,NOTA,None of the Above,2052,5,2057,1.05,Sarvepalli,119,Andhra Pradesh 
1731,ANNEM MALLIKHARJUN,Bahujan Samaj Party,1583,15,1598,0.82,Gudur,120,Andhra Pradesh 
1732,DR UYYALA RAMAKRISHNA RAO,Indian National Congress,3276,32,3308,1.7,Gudur,120,Andhra Pradesh 
1733,PASIM SUNIL KUMAR,Telugu Desam,100844,1831,102675,52.77,Gudur,120,Andhra Pradesh 
1734,MERIGA MURALIDHAR,Yuvajana Sramika Rythu Congress Party,80929,554,81483,41.88,Gudur,120,Andhra Pradesh 
1735,KARLA RAMESH BABU,Indian Believers Party (IBP),303,1,304,0.16,Gudur,120,Andhra Pradesh 
1736,GORRIPATI VENKATESWARLU,Jai Bharat National Party,178,0,178,0.09,Gudur,120,Andhra Pradesh 
1737,DURTHATI POLAMMA,Pyramid Party of India,225,3,228,0.12,Gudur,120,Andhra Pradesh 
1738,SUNEEL RAJU DARLA,Samajwadi Party,139,1,140,0.07,Gudur,120,Andhra Pradesh 
1739,THATIPARTHI BABU,Independent,232,0,232,0.12,Gudur,120,Andhra Pradesh 
1740,PALLI KOTESWARA RAO,Independent,200,0,200,0.1,Gudur,120,Andhra Pradesh 
1741,BIKKI VENKATA RAMANAIAH,Independent,133,1,134,0.07,Gudur,120,Andhra Pradesh 
1742,BODDU MURALI,Independent,180,0,180,0.09,Gudur,120,Andhra Pradesh 
1743,YALAPALLI SRINIVASULU,Independent,266,0,266,0.14,Gudur,120,Andhra Pradesh 
1744,VADANALA VENKAIAH,Independent,510,0,510,0.26,Gudur,120,Andhra Pradesh 
1745,NOTA,None of the Above,3119,10,3129,1.61,Gudur,120,Andhra Pradesh 
1746,KILIVETI SANJEEVAIAH,Yuvajana Sramika Rythu Congress Party,81362,571,81933,40.33,Sullurpeta,121,Andhra Pradesh 
1747,CHANDANAMUDI SIVA,Indian National Congress,4097,27,4124,2.03,Sullurpeta,121,Andhra Pradesh 
1748,TOPPANI RAMANAIAH,Bahujan Samaj Party,657,9,666,0.33,Sullurpeta,121,Andhra Pradesh 
1749,NELAVALA VIJAYASREE,Telugu Desam,109724,1324,111048,54.67,Sullurpeta,121,Andhra Pradesh 
1750,KANDATI RAJANIKANTH,Liberation Congress Party,516,4,520,0.26,Sullurpeta,121,Andhra Pradesh 
1751,BIGUVU SRINIVASULU,Samajwadi Party,181,0,181,0.09,Sullurpeta,121,Andhra Pradesh 
1752,NIDIGUNTA ARUNA,Independent,592,2,594,0.29,Sullurpeta,121,Andhra Pradesh 
1753,BURAKALA LEELA MOHAN,Independent,367,2,369,0.18,Sullurpeta,121,Andhra Pradesh 
1754,T.S.RAGHAVULU,Independent,280,0,280,0.14,Sullurpeta,121,Andhra Pradesh 
1755,NOTA,None of the Above,3410,13,3423,1.69,Sullurpeta,121,Andhra Pradesh 
1756,KURUGONDLA RAMAKRISHNA,Telugu Desam,102716,1682,104398,52.31,Venkatagiri,122,Andhra Pradesh 
1757,NEDURUMALLI RAM KUMAR REDDY,Yuvajana Sramika Rythu Congress Party,87262,842,88104,44.15,Venkatagiri,122,Andhra Pradesh 
1758,PERALA JAYACHANDRA,Bahujan Samaj Party,720,9,729,0.37,Venkatagiri,122,Andhra Pradesh 
1759,PANTA SRINIVASULU REDDY,Indian National Congress,1918,17,1935,0.97,Venkatagiri,122,Andhra Pradesh 
1760,S. NAGARAJU,Neethi Nijayithi Party,201,1,202,0.1,Venkatagiri,122,Andhra Pradesh 
1761,MUPPALLA SREERAMARAJU,Jai Bharat National Party,107,0,107,0.05,Venkatagiri,122,Andhra Pradesh 
1762,CH. SIVAKRISHNA,Bharatha Chaitanya Yuvajana Party,186,1,187,0.09,Venkatagiri,122,Andhra Pradesh 
1763,SHAIK SHAFI,Radical Party of India (Ambedkarist),223,3,226,0.11,Venkatagiri,122,Andhra Pradesh 
1764,ARMUGON. V,Independent,161,0,161,0.08,Venkatagiri,122,Andhra Pradesh 
1765,CH. VENKATACHALAPATHI,Independent,479,0,479,0.24,Venkatagiri,122,Andhra Pradesh 
1766,NOTA,None of the Above,3018,19,3037,1.52,Venkatagiri,122,Andhra Pradesh 
1767,ANIL KUMAR REDDY SOMU,Indian National Congress,2492,20,2512,1.25,Udayagiri,123,Andhra Pradesh 
1768,KAKARLA SURESH,Telugu Desam,99727,1810,101537,50.54,Udayagiri,123,Andhra Pradesh 
1769,KRAKUTURU PUSHPANJALI,Bahujan Samaj Party,958,20,978,0.49,Udayagiri,123,Andhra Pradesh 
1770,MEKAPATI RAJAGOPAL REDDY,Yuvajana Sramika Rythu Congress Party,90983,933,91916,45.75,Udayagiri,123,Andhra Pradesh 
1771,NALLAPANENI VENKATESWARLU,Pyramid Party of India,333,7,340,0.17,Udayagiri,123,Andhra Pradesh 
1772,PAIDI MANOHAR,Radical Party of India (Ambedkarist),77,1,78,0.04,Udayagiri,123,Andhra Pradesh 
1773,KETHIREDDY KRISHNA KUMAR REDDY,Independent,90,0,90,0.04,Udayagiri,123,Andhra Pradesh 
1774,CHERUKURI VENUGOPAL,Independent,81,1,82,0.04,Udayagiri,123,Andhra Pradesh 
1775,CHEJARLA SUBBA REDDY,Independent,87,1,88,0.04,Udayagiri,123,Andhra Pradesh 
1776,DONTHIREDDY NARASIMHA REDDY,Independent,63,0,63,0.03,Udayagiri,123,Andhra Pradesh 
1777,DR. MULA VENKATA RAMANA REDDY,Independent,86,2,88,0.04,Udayagiri,123,Andhra Pradesh 
1778,RAMESH DUDDUKURU,Independent,148,1,149,0.07,Udayagiri,123,Andhra Pradesh 
1779,RAVIPATI SAMBAIAH,Independent,324,0,324,0.16,Udayagiri,123,Andhra Pradesh 
1780,LEKKALA KONDAIAH,Independent,169,1,170,0.08,Udayagiri,123,Andhra Pradesh 
1781,VINJAM SRIKANTH,Independent,405,0,405,0.2,Udayagiri,123,Andhra Pradesh 
1782,NOTA,None of the Above,2063,9,2072,1.03,Udayagiri,123,Andhra Pradesh 
1783,DASARI SUDHA,Yuvajana Sramika Rythu Congress Party,89371,1039,90410,51.7,Badvel,124,Andhra Pradesh 
1784,NEERUGATTU DORA VIJAYA JYOTHI,Indian National Congress,7121,245,7366,4.21,Badvel,124,Andhra Pradesh 
1785,BOJJA ROSHANNA,Bharatiya Janata Party,70000,1843,71843,41.08,Badvel,124,Andhra Pradesh 
1786,SAGALI GURAPPA,Bahujan Samaj Party,652,7,659,0.38,Badvel,124,Andhra Pradesh 
1787,ALLURI SREENIVASULU,Jai Bharat National Party,135,6,141,0.08,Badvel,124,Andhra Pradesh 
1788,KAMAGANDLA OBAIAH,Super Rangers Party,128,1,129,0.07,Badvel,124,Andhra Pradesh 
1789,GAMGADHAR DODAGOLLA,Jana Sahayaka Sakthi,70,0,70,0.04,Badvel,124,Andhra Pradesh 
1790,BHAVANASI VENKATASUBBARAYUDU,Samajwadi Party,64,1,65,0.04,Badvel,124,Andhra Pradesh 
1791,SINGAMALA VENKATESHWARLU,All India Forward Bloc,64,0,64,0.04,Badvel,124,Andhra Pradesh 
1792,PASUPULA BALA KRISHNA,Independent,69,3,72,0.04,Badvel,124,Andhra Pradesh 
1793,MADDELA MALLIKARJUNA RAO,Independent,85,3,88,0.05,Badvel,124,Andhra Pradesh 
1794,MUNNELLI GURAIAH,Independent,162,0,162,0.09,Badvel,124,Andhra Pradesh 
1795,YAMBADI SINGARAIAH,Independent,251,0,251,0.14,Badvel,124,Andhra Pradesh 
1796,VANKELA SRINIVASULU,Independent,483,1,484,0.28,Badvel,124,Andhra Pradesh 
1797,NOTA,None of the Above,3056,20,3076,1.76,Badvel,124,Andhra Pradesh 
1798,AKEPATI AMARNATH REDDY,Yuvajana Sramika Rythu Congress Party,91746,863,92609,50.18,Rajampet,125,Andhra Pradesh 
1799,BALA SUBRAMANYAM SUGAVASI,Telugu Desam,83784,1809,85593,46.38,Rajampet,125,Andhra Pradesh 
1800,KOTAPATI SUBBAMMA,All India Forward Bloc,695,0,695,0.38,Rajampet,125,Andhra Pradesh 
1801,DUGGANAPALLI SURENDRA REDDY,Jaibhim Rao Bharat Party,346,0,346,0.19,Rajampet,125,Andhra Pradesh 
1802,DOMMA RAJU HARI PRASAD RAJU,Jai Bharat National Party,195,2,197,0.11,Rajampet,125,Andhra Pradesh 
1803,BUKKE VISWANATH NAIK,Communist Party of India,978,31,1009,0.55,Rajampet,125,Andhra Pradesh 
1804,GURRAMPATI VENKATA SUBBA REDDY,Independent,92,0,92,0.05,Rajampet,125,Andhra Pradesh 
1805,RAGHAVENDRA VARMA RENATI,Independent,269,2,271,0.15,Rajampet,125,Andhra Pradesh 
1806,REDAM CHINNA PENCHALAIAH,Independent,859,9,868,0.47,Rajampet,125,Andhra Pradesh 
1807,SHAIK MAHAMMAD ADIL,Independent,402,3,405,0.22,Rajampet,125,Andhra Pradesh 
1808,SHAIK. SALMAN,Independent,540,3,543,0.29,Rajampet,125,Andhra Pradesh 
1809,HARI ROYAL KONETI,Independent,312,0,312,0.17,Rajampet,125,Andhra Pradesh 
1810,NOTA,None of the Above,1605,12,1617,0.88,Rajampet,125,Andhra Pradesh 
1811,T.K. AFZAL. ALI KHAN,Indian National Congress,24246,254,24500,12.86,kadapa,126,Andhra Pradesh 
1812,AMZATH BASHA SHAIK BEPARI,Yuvajana Sramika Rythu Congress Party,70881,1247,72128,37.86,kadapa,126,Andhra Pradesh 
1813,MADHAVI REDDAPPA GARI,Telugu Desam,87163,3825,90988,47.76,kadapa,126,Andhra Pradesh 
1814,VENKATA SUBBA REDDY RAJU,Bahujan Samaj Party,359,1,360,0.19,kadapa,126,Andhra Pradesh 
1815,AKBER MAHABOOB BASHA,Anna YSR Congress Party,115,1,116,0.06,kadapa,126,Andhra Pradesh 
1816,AVVARU MALLIKARJUNA,Jaathia Chethi Vruthula Ikya Vedika Party,112,5,117,0.06,kadapa,126,Andhra Pradesh 
1817,PATTUPOGULA PAVAN KUMAR,National Maha Sabha Party,275,10,285,0.15,kadapa,126,Andhra Pradesh 
1818,SETTYPALLE SUBRAMANYAM,Reforms Party of India,101,4,105,0.06,kadapa,126,Andhra Pradesh 
1819,SHAIK ALISHARE,Indian Union Muslim League,67,2,69,0.04,kadapa,126,Andhra Pradesh 
1820,AHMED BASHA SHAIK BEPARI,Independent,80,5,85,0.04,kadapa,126,Andhra Pradesh 
1821,LOMADA CHANDRA MOHAN REDDY,Independent,64,0,64,0.03,kadapa,126,Andhra Pradesh 
1822,VEMPALLI DWARAKA NATH REDDY,Independent,111,0,111,0.06,kadapa,126,Andhra Pradesh 
1823,SUDHAKAR PANETI,Independent,154,1,155,0.08,kadapa,126,Andhra Pradesh 
1824,NOTA,None of the Above,1398,46,1444,0.76,kadapa,126,Andhra Pradesh 
1825,KORAMUTLA SREENIVASULU,Yuvajana Sramika Rythu Congress Party,67002,491,67493,43.88,Kodur (SC),127,Andhra Pradesh 
1826,DEVI GOSALA,Indian National Congress,2113,19,2132,1.39,Kodur (SC),127,Andhra Pradesh 
1827,SUBRAMANYAM TALLAPAKA,Bahujan Samaj Party,869,8,877,0.57,Kodur (SC),127,Andhra Pradesh 
1828,ARAVA SREEDHAR,Janasena Party,77701,893,78594,51.1,Kodur (SC),127,Andhra Pradesh 
1829,DARLA GOUTHAM KUMAR,Jaathia Chethi Vruthula Ikya Vedika Party,368,0,368,0.24,Kodur (SC),127,Andhra Pradesh 
1830,MAHESH REDDYPAKU,Bharatha Chaitanya Yuvajana Party,519,3,522,0.34,Kodur (SC),127,Andhra Pradesh 
1831,MANDAPALLI SRINIVASULU,Pyramid Party of India,144,0,144,0.09,Kodur (SC),127,Andhra Pradesh 
1832,AMBATI SIVAIAH,Independent,267,2,269,0.17,Kodur (SC),127,Andhra Pradesh 
1833,TUMMALA SURESH,Independent,263,1,264,0.17,Kodur (SC),127,Andhra Pradesh 
1834,DAMARLA SIDDAIAH,Independent,272,4,276,0.18,Kodur (SC),127,Andhra Pradesh 
1835,MANI MARELLA,Independent,286,0,286,0.19,Kodur (SC),127,Andhra Pradesh 
1836,YEDUKA ANJI BABU,Independent,125,0,125,0.08,Kodur (SC),127,Andhra Pradesh 
1837,LAKSHMI NARASAIAH PANDIKALLA,Independent,848,1,849,0.55,Kodur (SC),127,Andhra Pradesh 
1838,LAKSHMI NARESH KAAKI,Independent,268,1,269,0.17,Kodur (SC),127,Andhra Pradesh 
1839,SUBBANARASAIAH CHOUDVARAM,Independent,224,1,225,0.15,Kodur (SC),127,Andhra Pradesh 
1840,NOTA,None of the Above,1097,15,1112,0.72,Kodur (SC),127,Andhra Pradesh 
1841,GADIKOTA SRIKANTH REDDY,Yuvajana Sramika Rythu Congress Party,92481,949,93430,46.74,Rayachoti,128,Andhra Pradesh 
1842,BUSAPOGULA ANJINEYULU,Bahujan Samaj Party,1288,1,1289,0.64,Rayachoti,128,Andhra Pradesh 
1843,MANDIPALLI RAMPRASAD REDDY,Telugu Desam,93836,2089,95925,47.99,Rayachoti,128,Andhra Pradesh 
1844,SHAIK ALLABAKASH,Indian National Congress,5529,42,5571,2.79,Rayachoti,128,Andhra Pradesh 
1845,ANANTHAPURAM HARI KRISHNA,Liberation Congress Party,305,3,308,0.15,Rayachoti,128,Andhra Pradesh 
1846,GUDI MADHU SUDHAN,Jai Bharat National Party,149,0,149,0.07,Rayachoti,128,Andhra Pradesh 
1847,MULALA CHIDAMBAR REDDY,Indian Praja Congress,169,0,169,0.08,Rayachoti,128,Andhra Pradesh 
1848,MANOHAR REPANA,Anna YSR Congress Party,172,1,173,0.09,Rayachoti,128,Andhra Pradesh 
1849,SHAIK SHAPABUL BASHA,Indian Union Muslim League,125,0,125,0.06,Rayachoti,128,Andhra Pradesh 
1850,SHAIK JEELAN BASHA,Jatiya Jana Sena Party,82,0,82,0.04,Rayachoti,128,Andhra Pradesh 
1851,SHAIK DARBAR ALI,Navarang Congress Party,94,1,95,0.05,Rayachoti,128,Andhra Pradesh 
1852,PENUGONDA VENKATARAMANA,Independent,101,0,101,0.05,Rayachoti,128,Andhra Pradesh 
1853,VATTAM NARESH KUMAR REDDY,Independent,141,1,142,0.07,Rayachoti,128,Andhra Pradesh 
1854,KOTHA SREEKANTH REDDY,Independent,418,0,418,0.21,Rayachoti,128,Andhra Pradesh 
1855,SHAIK MOHAMMED GHOUSE,Independent,332,0,332,0.17,Rayachoti,128,Andhra Pradesh 
1856,NOTA,None of the Above,1578,14,1592,0.8,Rayachoti,128,Andhra Pradesh 
1857,YS JAGAN MOHAN REDDY,Yuvajana Sramika Rythu Congress Party,114751,1564,116315,61.38,Pulivendla,129,Andhra Pradesh 
1858,DHRUVA KUMAR REDDY,Indian National Congress,10051,32,10083,5.32,Pulivendla,129,Andhra Pradesh 
1859,BELLAM PRAVEEN KUMAR REDDI,Bahujan Samaj Party,955,3,958,0.51,Pulivendla,129,Andhra Pradesh 
1860,B.TECH RAVI,Telugu Desam,53582,1046,54628,28.83,Pulivendla,129,Andhra Pradesh 
1861,KARNA RAMESH KUMAR REDDY,All India Forward Bloc,146,0,146,0.08,Pulivendla,129,Andhra Pradesh 
1862,KANCHERLA VENKATA SARVOTHAMA REDDY,Super Rangers Party,32,0,32,0.02,Pulivendla,129,Andhra Pradesh 
1863,GAVIREDDY RAMESWAR REDDY,Pyramid Party of India,62,0,62,0.03,Pulivendla,129,Andhra Pradesh 
1864,DASARI RAVI SANKAR,Jai Bharat National Party,41,2,43,0.02,Pulivendla,129,Andhra Pradesh 
1865,MADEM PUSHPANATHA REDDY,Jana Sahayaka Sakthi,37,0,37,0.02,Pulivendla,129,Andhra Pradesh 
1866,YADIKI BOREDDY CHINNA YERIKALA REDDY,Andhra Rastra Praja Samithi,29,1,30,0.02,Pulivendla,129,Andhra Pradesh 
1867,RAVITHEJA REDDY AJUGUTTU,Radical Party of India (Ambedkarist),53,1,54,0.03,Pulivendla,129,Andhra Pradesh 
1868,RAGHAVAREDDY TUGUTLA,Navarang Congress Party,69,0,69,0.04,Pulivendla,129,Andhra Pradesh 
1869,LINGALA RAMA LINGA REDDY,Rashtriya Janata Dal,118,1,119,0.06,Pulivendla,129,Andhra Pradesh 
1870,VIJAY KUMAR REDDY AKKULUGARI,Revolutionary Socialist Party,202,0,202,0.11,Pulivendla,129,Andhra Pradesh 
1871,SIVA CHANDRA REDDY KOMMA,Anna YSR Congress Party,232,1,233,0.12,Pulivendla,129,Andhra Pradesh 
1872,SHAIK. DASTHA GIRI,Jaibhim Rao Bharat Party,543,1,544,0.29,Pulivendla,129,Andhra Pradesh 
1873,SURE NIRMALA YADAV,Bharatha Chaitanya Yuvajana Party,2579,3,2582,1.36,Pulivendla,129,Andhra Pradesh 
1874,EMIREDDY KRISHNA REDDY,Independent,640,0,640,0.34,Pulivendla,129,Andhra Pradesh 
1875,GOKANAPALLI VARAPRASAD REDDY,Independent,242,0,242,0.13,Pulivendla,129,Andhra Pradesh 
1876,CHANDRASEKHAR REDDY SIVAIAH GARI,Independent,210,0,210,0.11,Pulivendla,129,Andhra Pradesh 
1877,PANDILLAPALLE RAMA GANGI REDDY,Independent,113,0,113,0.06,Pulivendla,129,Andhra Pradesh 
1878,MAHAMMAD DARBAR BASHA NIMMAKAYALA,Independent,50,0,50,0.03,Pulivendla,129,Andhra Pradesh 
1879,MAHESWARA REDDY TALLAPALLE,Independent,50,0,50,0.03,Pulivendla,129,Andhra Pradesh 
1880,VIJAYA BHASKAR REDDY LOMADA,Independent,36,0,36,0.02,Pulivendla,129,Andhra Pradesh 
1881,VENKATASREDHAR REDDY PUPPALA,Independent,57,0,57,0.03,Pulivendla,129,Andhra Pradesh 
1882,SYED THAUFIQ ALIAS SYED MYNUDDIN,Independent,74,1,75,0.04,Pulivendla,129,Andhra Pradesh 
1883,SANJEEVA REDDY DEVIREDDY,Independent,118,0,118,0.06,Pulivendla,129,Andhra Pradesh 
1884,NOTA,None of the Above,1745,19,1764,0.93,Pulivendla,129,Andhra Pradesh 
1885,KRISHNA CHAITANYA REDDY PUTHA,Telugu Desam,93898,1309,95207,55.29,Kamalapuram,130,Andhra Pradesh 
1886,CHINNARIGANDLA BALA CHENNAIAH,Bahujan Samaj Party,2257,4,2261,1.31,Kamalapuram,130,Andhra Pradesh 
1887,POCHIMAREDDY RAVINDRANATH REDDY,Yuvajana Sramika Rythu Congress Party,69244,606,69850,40.56,Kamalapuram,130,Andhra Pradesh 
1888,GALI CHANDRA,Communist Party of India,1085,7,1092,0.63,Kamalapuram,130,Andhra Pradesh 
1889,NARREDDY KISHORE REDDY,Jai Swaraj Party,192,1,193,0.11,Kamalapuram,130,Andhra Pradesh 
1890,PAMUJULA SIVA RAMA BRAMHMAM GOUD,Pyramid Party of India,113,2,115,0.07,Kamalapuram,130,Andhra Pradesh 
1891,PUTHA NAGESHWARA REDDY,Young Senior Rich Common People Kings Party,85,1,86,0.05,Kamalapuram,130,Andhra Pradesh 
1892,MADHUSUDHANA REDDY GUMMALLA,Independent,74,0,74,0.04,Kamalapuram,130,Andhra Pradesh 
1893,YARAMALA ANITHA,Independent,144,1,145,0.08,Kamalapuram,130,Andhra Pradesh 
1894,RAJASEKHAR REDDY LINGALA,Independent,222,0,222,0.13,Kamalapuram,130,Andhra Pradesh 
1895,VEERANARAYANA REDDY RAJOLI,Independent,819,4,823,0.48,Kamalapuram,130,Andhra Pradesh 
1896,NOTA,None of the Above,2113,15,2128,1.24,Kamalapuram,130,Andhra Pradesh 
1897,ADINARAYANA REDDY CHADIPIRALA,Bharatiya Janata Party,107875,1765,109640,51.43,Jammalamadugu ,131,Andhra Pradesh 
1898,GUDISENAPALLI OBAIAH,Bahujan Samaj Party,1788,3,1791,0.84,Jammalamadugu ,131,Andhra Pradesh 
1899,BRAMHANANDA REDDY PAMULA,Indian National Congress,4178,44,4222,1.98,Jammalamadugu ,131,Andhra Pradesh 
1900,MULE SUDHEER REDDY,Yuvajana Sramika Rythu Congress Party,91563,886,92449,43.37,Jammalamadugu ,131,Andhra Pradesh 
1901,CHINTHALA ESAIAH,Bharosa Party,270,1,271,0.13,Jammalamadugu ,131,Andhra Pradesh 
1902,P. CHANDRA SEKHAR REDDY,Jaibhim Rao Bharat Party,224,1,225,0.11,Jammalamadugu ,131,Andhra Pradesh 
1903,B. PULLA REDDY,Navarang Congress Party,112,0,112,0.05,Jammalamadugu ,131,Andhra Pradesh 
1904,MUDRABOINA NAGABHOOSHANAM,Pyramid Party of India,104,0,104,0.05,Jammalamadugu ,131,Andhra Pradesh 
1905,RAMESH YADDULA,Samajwadi Party,83,0,83,0.04,Jammalamadugu ,131,Andhra Pradesh 
1906,ALLE PRABHAVATHI,Independent,706,4,710,0.33,Jammalamadugu ,131,Andhra Pradesh 
1907,V. JAGADEESWARA REDDY,Independent,153,0,153,0.07,Jammalamadugu ,131,Andhra Pradesh 
1908,RAMOOJI EMMANIYELU,Independent,88,1,89,0.04,Jammalamadugu ,131,Andhra Pradesh 
1909,VEERA RAGHU VARDHAN REDDY CHADIPIRALLA,Independent,233,0,233,0.11,Jammalamadugu ,131,Andhra Pradesh 
1910,VENKATA SUBBA REDDY THIMAREDDY,Independent,228,0,228,0.11,Jammalamadugu ,131,Andhra Pradesh 
1911,C. SIVA NARAYANA REDDY,Independent,467,1,468,0.22,Jammalamadugu ,131,Andhra Pradesh 
1912,NOTA,None of the Above,2359,33,2392,1.12,Jammalamadugu ,131,Andhra Pradesh 
1913,NANDYALA VARADA RAJULA REDDY,Telugu Desam,104272,2440,106712,53.02,Proddatur ,132,Andhra Pradesh 
1914,PICHOLLA SUBBARAYUDU,Bahujan Samaj Party,1732,1,1733,0.86,Proddatur ,132,Andhra Pradesh 
1915,RACHAMALLU SIVA PRASAD REDDY,Yuvajana Sramika Rythu Congress Party,82919,1049,83968,41.72,Proddatur ,132,Andhra Pradesh 
1916,SHAIK POOLA MAHAMMAD NAZEER,Indian National Congress,5983,33,6016,2.99,Proddatur ,132,Andhra Pradesh 
1917,T. KARUNAKAR,Jaibhim Rao Bharat Party,187,5,192,0.1,Proddatur ,132,Andhra Pradesh 
1918,GUNDLADURTHI SEETHARAMIREDDY,Jai Maha Bharath Party,59,1,60,0.03,Proddatur ,132,Andhra Pradesh 
1919,POGAKU HANUMANTHA REDDY,Pyramid Party of India,90,0,90,0.04,Proddatur ,132,Andhra Pradesh 
1920,POTHUGANTI RAFI,Jai Bharat National Party,91,0,91,0.05,Proddatur ,132,Andhra Pradesh 
1921,MAHMMED RAFI,Navarang Congress Party,70,1,71,0.04,Proddatur ,132,Andhra Pradesh 
1922,P. MUNI REDDY BANGARU,All India Forward Bloc,41,2,43,0.02,Proddatur ,132,Andhra Pradesh 
1923,E. L. V. SURESH BABU,Jaathia Chethi Vruthula Ikya Vedika Party,67,2,69,0.03,Proddatur ,132,Andhra Pradesh 
1924,CHANDRA PRABHAKARA REDDY PALLETI,Independent,111,0,111,0.06,Proddatur ,132,Andhra Pradesh 
1925,PUTTA LAKSHMI REDDY,Independent,64,0,64,0.03,Proddatur ,132,Andhra Pradesh 
1926,BOLLAVARAM VENKATA PRASAD REDDY,Independent,123,2,125,0.06,Proddatur ,132,Andhra Pradesh 
1927,T. RAVI KUMAR,Independent,199,0,199,0.1,Proddatur ,132,Andhra Pradesh 
1928,NOTA,None of the Above,1698,42,1740,0.86,Proddatur ,132,Andhra Pradesh 
1929,DASARI SADAYYAGARI KALYAN,Bahujan Samaj Party,1425,4,1429,0.79,Mydukur,133,Andhra Pradesh 
1930,GUNDLAKUNTA SREERAMULU,Indian National Congress,4557,22,4579,2.53,Mydukur,133,Andhra Pradesh 
1931,SUDHAKAR PUTTA,Telugu Desam,94426,1755,96181,53.22,Mydukur,133,Andhra Pradesh 
1932,RAGHURAMI REDDY SETTIPALLY,Yuvajana Sramika Rythu Congress Party,74519,712,75231,41.62,Mydukur,133,Andhra Pradesh 
1933,ANANDA RAO PANDITI,Andhra Rastra Praja Samithi,677,2,679,0.38,Mydukur,133,Andhra Pradesh 
1934,AVUTALA RAJESWARA REDDY,All India Forward Bloc,53,0,53,0.03,Mydukur,133,Andhra Pradesh 
1935,YELLUGALLA RAJESH,Mahajana Rajyam Party,50,0,50,0.03,Mydukur,133,Andhra Pradesh 
1936,RAGHURAMI REDDY MUTHURU,Revolutionary Socialist Party,85,5,90,0.05,Mydukur,133,Andhra Pradesh 
1937,RAVEENDRA ANDE,Samajwadi Party,38,0,38,0.02,Mydukur,133,Andhra Pradesh 
1938,LEKKALA SREENUVASULA REDDY,Jai Bharat National Party,117,0,117,0.06,Mydukur,133,Andhra Pradesh 
1939,VENKATA SUDHAKAR REDDY PALLAVOLU,Rashtriya Samaj Dal (R),41,2,43,0.02,Mydukur,133,Andhra Pradesh 
1940,AVULA VENKATA RAMANA,Independent,102,0,102,0.06,Mydukur,133,Andhra Pradesh 
1941,BALAIAH YADAV POTHANABOINA,Independent,95,0,95,0.05,Mydukur,133,Andhra Pradesh 
1942,RAJA RAMI REDDY SRIYAPUREDDY,Anna YSR Congress Party,169,0,169,0.09,Mydukur,133,Andhra Pradesh 
1943,SIVA SANKAR REDDY SIDDAMREDDY,Independent,318,2,320,0.18,Mydukur,133,Andhra Pradesh 
1944,NOTA,None of the Above,1548,16,1564,0.87,Mydukur,133,Andhra Pradesh 
1945,ISMAIL.A.S,Indian National Congress,3391,38,3429,2.08,Srisailam,135,Andhra Pradesh 
1946,PALLE.CHANDRA SEKHAR,Bahujan Samaj Party,555,12,567,0.34,Srisailam,135,Andhra Pradesh 
1947,BUDDA RAJASEKHARA REDDY,Telugu Desam,80630,1069,81699,49.64,Srisailam,135,Andhra Pradesh 
1948,SILPA CHAKRAPANI REDDY,Yuvajana Sramika Rythu Congress Party,74689,625,75314,45.76,Srisailam,135,Andhra Pradesh 
1949,GOONDLA MALLIKARJUNA GOUD (PANDU),National Maha Sabha Party,223,1,224,0.14,Srisailam,135,Andhra Pradesh 
1950,CHINTA NAGESWARA RAO,Jaathia Chethi Vruthula Ikya Vedika Party,108,1,109,0.07,Srisailam,135,Andhra Pradesh 
1951,MADHU YENNAKANDLA,Samajwadi Party,61,0,61,0.04,Srisailam,135,Andhra Pradesh 
1952,K.MADHU GOUD,Naba Bharata Nirmana Seva Party,85,1,86,0.05,Srisailam,135,Andhra Pradesh 
1953,MEDIGA SUSHMITHA,Jaibhim Rao Bharat Party,68,2,70,0.04,Srisailam,135,Andhra Pradesh 
1954,N.K.YUNUS,Social Democratic Party Of India,746,4,750,0.46,Srisailam,135,Andhra Pradesh 
1955,LOKESWARA REDDY YELLAMPALLE,Jai Hindustan Party,61,2,63,0.04,Srisailam,135,Andhra Pradesh 
1956,VELUGOTI JAYA NARAPU REDDY,Jatiya Jana Sena Party,52,3,55,0.03,Srisailam,135,Andhra Pradesh 
1957,SYED MAHAMMAD SIKINDHAR BASHA,Jai Bharat National Party,169,2,171,0.1,Srisailam,135,Andhra Pradesh 
1958,ALLE ESWARA REDDY,Independent,139,1,140,0.09,Srisailam,135,Andhra Pradesh 
1959,YENDLURI THIMAYYA,Independent,110,1,111,0.07,Srisailam,135,Andhra Pradesh 
1960,JAYA KUMARA SWAMY,Independent,282,0,282,0.17,Srisailam,135,Andhra Pradesh 
1961,PATTEKALLA ELIYAS,Independent,163,2,165,0.1,Srisailam,135,Andhra Pradesh 
1962,PEDDIREDDY GANGADHARAREDDY,Independent,205,2,207,0.13,Srisailam,135,Andhra Pradesh 
1963,NOTA,None of the Above,1067,10,1077,0.65,Srisailam,135,Andhra Pradesh 
1964,GADDALA LAZAR,Bahujan Samaj Party,524,5,529,0.28,Nandikotkur (SC),136,Andhra Pradesh 
1965,G JAYASURYA,Telugu Desam,90804,1200,92004,49.24,Nandikotkur (SC),136,Andhra Pradesh 
1966,THOGURU ARTHUR,Indian National Congress,7844,105,7949,4.25,Nandikotkur (SC),136,Andhra Pradesh 
1967,DARA SUDHEER,Yuvajana Sramika Rythu Congress Party,81535,677,82212,44,Nandikotkur (SC),136,Andhra Pradesh 
1968,E. KARUNAKAR,Super Rangers Party,250,0,250,0.13,Nandikotkur (SC),136,Andhra Pradesh 
1969,NAKKA RAJESH,Samajwadi Party,71,0,71,0.04,Nandikotkur (SC),136,Andhra Pradesh 
1970,PALLE NAGARAJU,India Praja Bandhu Party,80,0,80,0.04,Nandikotkur (SC),136,Andhra Pradesh 
1971,PULA HARI BABU,Andhra Rastra Praja Samithi,72,0,72,0.04,Nandikotkur (SC),136,Andhra Pradesh 
1972,BORELLI VENKATA RAMUDU,Jai Bharat National Party,172,3,175,0.09,Nandikotkur (SC),136,Andhra Pradesh 
1973,VENKATARAMANA CHIMME,Bharatha Chaitanya Yuvajana Party,158,6,164,0.09,Nandikotkur (SC),136,Andhra Pradesh 
1974,K VENKATESWARLU,Jaathia Chethi Vruthula Ikya Vedika Party,102,2,104,0.06,Nandikotkur (SC),136,Andhra Pradesh 
1975,SABOLU LINCOLN RAJU,Social Democratic Party Of India,359,2,361,0.19,Nandikotkur (SC),136,Andhra Pradesh 
1976,SAGINELA VENKATESHWARLU,Anna YSR Congress Party,124,3,127,0.07,Nandikotkur (SC),136,Andhra Pradesh 
1977,SOGARAJU MUNAIAH,Liberation Congress Party,164,0,164,0.09,Nandikotkur (SC),136,Andhra Pradesh 
1978,GADE SUDHEER,Independent,258,0,258,0.14,Nandikotkur (SC),136,Andhra Pradesh 
1979,K JAYANNA,Independent,428,1,429,0.23,Nandikotkur (SC),136,Andhra Pradesh 
1980,PEDISHALA SRINIVASULU,Independent,147,0,147,0.08,Nandikotkur (SC),136,Andhra Pradesh 
1981,MIDDE BALARAJU,Independent,483,0,483,0.26,Nandikotkur (SC),136,Andhra Pradesh 
1982,NOTA,None of the Above,1260,14,1274,0.68,Nandikotkur (SC),136,Andhra Pradesh 
1983,ARUNA KUMAR .G,Bahujan Samaj Party,1776,17,1793,1,Kurnool,137,Andhra Pradesh 
1984,"A. MD. IMTIAZ I.A.S., (RETD)",Yuvajana Sramika Rythu Congress Party,71777,1037,72814,40.77,Kurnool,137,Andhra Pradesh 
1985,T.G.BHARATH,Telugu Desam,89281,2409,91690,51.34,Kurnool,137,Andhra Pradesh 
1986,SHAIK JELANI BASHA,Indian National Congress,8907,115,9022,5.05,Kurnool,137,Andhra Pradesh 
1987,ABDUL SATTAR (A.S.R),Anna YSR Congress Party,106,3,109,0.06,Kurnool,137,Andhra Pradesh 
1988,KURUVA NAGESH,All India Kisan Janatha party,31,0,31,0.02,Kurnool,137,Andhra Pradesh 
1989,KHALEEL AHMED SHAIK,Social Democratic Party Of India,484,12,496,0.28,Kurnool,137,Andhra Pradesh 
1990,A.P.RAMAIAH YADAV,Jateeya Sama Samajam Party,110,1,111,0.06,Kurnool,137,Andhra Pradesh 
1991,SANDYAPOGU RAGHAVENDRA,Super Rangers Party,27,0,27,0.02,Kurnool,137,Andhra Pradesh 
1992,HARISH KUMAR REDDY .V,Socialist Unity Centre Of India (COMMUNIST),63,0,63,0.04,Kurnool,137,Andhra Pradesh 
1993,INTHIAZ,Independent,56,0,56,0.03,Kurnool,137,Andhra Pradesh 
1994,JAMEELA BEGUM SYED,Independent,27,0,27,0.02,Kurnool,137,Andhra Pradesh 
1995,S.NAZEER AHMED,Independent,48,0,48,0.03,Kurnool,137,Andhra Pradesh 
1996,B.K.NAGA RAJU,Independent,62,0,62,0.03,Kurnool,137,Andhra Pradesh 
1997,S.NOUSHAD,Independent,165,1,166,0.09,Kurnool,137,Andhra Pradesh 
1998,PULI JACOB,Independent,150,1,151,0.08,Kurnool,137,Andhra Pradesh 
1999,B. PRASADA RAO,Independent,145,0,145,0.08,Kurnool,137,Andhra Pradesh 
2000,BADAI FASIHA NAAZ,Independent,152,1,153,0.09,Kurnool,137,Andhra Pradesh 
2001,BANNURU CHANDRA SEKHAR REDDY,Independent,131,0,131,0.07,Kurnool,137,Andhra Pradesh 
2002,BHARATH N,Independent,458,5,463,0.26,Kurnool,137,Andhra Pradesh 
2003,RAVI KUMAR .V,Independent,134,5,139,0.08,Kurnool,137,Andhra Pradesh 
2004,SINGARI CHANDRA SEKHAR,Independent,17,0,17,0.01,Kurnool,137,Andhra Pradesh 
2005,B.SREENIVASA RAO,Independent,52,1,53,0.03,Kurnool,137,Andhra Pradesh 
2006,M.SRI HARSHA,Independent,89,2,91,0.05,Kurnool,137,Andhra Pradesh 
2007,HUSSAIN PEERAN SAHEB BUVVAJI CHINNA,Independent,18,0,18,0.01,Kurnool,137,Andhra Pradesh 
2008,NOTA,None of the Above,695,23,718,0.4,Kurnool,137,Andhra Pradesh 
2009,KATASANI RAMABHUPAL REDDY,Yuvajana Sramika Rythu Congress Party,99234,1447,100681,40.23,Panyam,138,Andhra Pradesh 
2010,GOWRU CHARITHA REDDY,Telugu Desam,137743,3529,141272,56.45,Panyam,138,Andhra Pradesh 
2011,GOUSE DESAI,Communist Party of India (Marxist),2995,86,3081,1.23,Panyam,138,Andhra Pradesh 
2012,DASARI RAMA SESHAIAH,Bahujan Samaj Party,639,16,655,0.26,Panyam,138,Andhra Pradesh 
2013,K.KRISHNAMACHARI,Andhra Rastra Praja Samithi,149,0,149,0.06,Panyam,138,Andhra Pradesh 
2014,M.JAMANNA,Jana Sahayaka Sakthi,116,0,116,0.05,Panyam,138,Andhra Pradesh 
2015,TELUGU BHASKAR,Navarang Congress Party,149,0,149,0.06,Panyam,138,Andhra Pradesh 
2016,BATHULA CHINNAIAH,All India Forward Bloc,150,3,153,0.06,Panyam,138,Andhra Pradesh 
2017,BOGGULA MAHENDRA BABU,Super Rangers Party,99,1,100,0.04,Panyam,138,Andhra Pradesh 
2018,MALLAPU RAJU,India Praja Bandhu Party,122,2,124,0.05,Panyam,138,Andhra Pradesh 
2019,REGATI RAGHU RAMI REDDY,Jai Bharat National Party,164,6,170,0.07,Panyam,138,Andhra Pradesh 
2020,HARUN DUDEKULA,Anna YSR Congress Party,163,4,167,0.07,Panyam,138,Andhra Pradesh 
2021,CHIRANJEEVI PUSULURI,Independent,301,2,303,0.12,Panyam,138,Andhra Pradesh 
2022,J. SEETHAMMA,Independent,490,3,493,0.2,Panyam,138,Andhra Pradesh 
2023,NOTA,None of the Above,2602,61,2663,1.06,Panyam,138,Andhra Pradesh 
2024,GOPAVARAM GOKUL KRISHNA REDDY,Indian National Congress,6346,72,6418,3.08,Nandyal,139,Andhra Pradesh 
2025,NASYAM MOHAMMED FAROOK,Telugu Desam,100606,2469,103075,49.42,Nandyal,139,Andhra Pradesh 
2026,I.J.VENKATA RAMANA,Bahujan Samaj Party,1104,9,1113,0.53,Nandyal,139,Andhra Pradesh 
2027,SILPA RAVI CHANDRA KISHORE REDDY,Yuvajana Sramika Rythu Congress Party,89317,1425,90742,43.51,Nandyal,139,Andhra Pradesh 
2028,ABDULLAH SHARIF SHAIK,Jai Hindustan Party,289,2,291,0.14,Nandyal,139,Andhra Pradesh 
2029,YELLA SUBBARAYUDU,Jatiya Jana Sena Party,85,1,86,0.04,Nandyal,139,Andhra Pradesh 
2030,KAPPETA ADI NARAYANA REDDY,Naba Bharata Nirmana Seva Party,92,1,93,0.04,Nandyal,139,Andhra Pradesh 
2031,GANJI VENKATESWARLU,Jaathia Chethi Vruthula Ikya Vedika Party,75,1,76,0.04,Nandyal,139,Andhra Pradesh 
2032,CHINTALAPALLE SUDHAKARA RAO,Bharatha Chaitanya Yuvajana Party,52,0,52,0.02,Nandyal,139,Andhra Pradesh 
2033,K.C.CHENNAIAH,Jaibhim Rao Bharat Party,75,0,75,0.04,Nandyal,139,Andhra Pradesh 
2034,S.BABA FAKRUDDIN,Navarang Congress Party,72,2,74,0.04,Nandyal,139,Andhra Pradesh 
2035,MANJULA SUBBARAYUDU,All Peoples Party,80,1,81,0.04,Nandyal,139,Andhra Pradesh 
2036,RAMESH SALLA,Yuga Thulasi Party,367,8,375,0.18,Nandyal,139,Andhra Pradesh 
2037,K RAGHAVENDRA,Neethi Nijayithi Party,79,0,79,0.04,Nandyal,139,Andhra Pradesh 
2038,S. ABBAS,Indian Union Muslim League,122,1,123,0.06,Nandyal,139,Andhra Pradesh 
2039,SHAIK MAHAMMAD FAZIL,Social Democratic Party Of India,2403,18,2421,1.16,Nandyal,139,Andhra Pradesh 
2040,KAMINI VISHNUVARDHAN REDDY,Independent,100,4,104,0.05,Nandyal,139,Andhra Pradesh 
2041,CHINNA RAJU PERI,Independent,282,0,282,0.14,Nandyal,139,Andhra Pradesh 
2042,DASARI CHINNA LINGAMAIAH,Independent,202,2,204,0.1,Nandyal,139,Andhra Pradesh 
2043,Y. NAGASESHU,Independent,146,0,146,0.07,Nandyal,139,Andhra Pradesh 
2044,MADDELA CHANDRA SEKHAR,Independent,134,0,134,0.06,Nandyal,139,Andhra Pradesh 
2045,DEVARAPATI RAVI KUMAR,Independent,110,1,111,0.05,Nandyal,139,Andhra Pradesh 
2046,RAMAYANAM HYGREEVACHARI,Independent,510,12,522,0.25,Nandyal,139,Andhra Pradesh 
2047,LAKKA. KESAVA,Independent,61,1,62,0.03,Nandyal,139,Andhra Pradesh 
2048,VIKRAM BABU,Independent,144,0,144,0.07,Nandyal,139,Andhra Pradesh 
2049,K.AJ.S. VIJAYA KUMAR,Independent,47,1,48,0.02,Nandyal,139,Andhra Pradesh 
2050,B. SRAVAN KUMAR,Independent,46,2,48,0.02,Nandyal,139,Andhra Pradesh 
2051,SHAIK RIYAZ,Independent,81,0,81,0.04,Nandyal,139,Andhra Pradesh 
2052,NOTA,None of the Above,1468,50,1518,0.73,Nandyal,139,Andhra Pradesh 
2053,KATASANI RAMI REDDY,Yuvajana Sramika Rythu Congress Party,84320,717,85037,41.33,Banaganapalle,140,Andhra Pradesh 
2054,GUTAM PULLAIAH (BALU YADAV),Indian National Congress,3319,25,3344,1.63,Banaganapalle,140,Andhra Pradesh 
2055,G. CHENNAYYA,Bahujan Samaj Party,1029,1,1030,0.5,Banaganapalle,140,Andhra Pradesh 
2056,B.C. JANARDHAN REDDY,Telugu Desam,109194,1409,110603,53.76,Banaganapalle,140,Andhra Pradesh 
2057,GOGULA SUGUNAMMA,Jai Maha Bharath Party,346,1,347,0.17,Banaganapalle,140,Andhra Pradesh 
2058,CHINNA SHETTI VENKATASUBBAYYA,Jaathia Chethi Vruthula Ikya Vedika Party,89,0,89,0.04,Banaganapalle,140,Andhra Pradesh 
2059,AMBATI RAVI KUMAR REDDY,Independent,44,0,44,0.02,Banaganapalle,140,Andhra Pradesh 
2060,EDIGA GURU PRADEEP,Independent,80,0,80,0.04,Banaganapalle,140,Andhra Pradesh 
2061,KASIREDDY RAGHUNATHA REDDY,Independent,97,1,98,0.05,Banaganapalle,140,Andhra Pradesh 
2062,KALINGIRI RAMUDU,Independent,74,0,74,0.04,Banaganapalle,140,Andhra Pradesh 
2063,KEDAM SUBBARAYUDU,Independent,96,1,97,0.05,Banaganapalle,140,Andhra Pradesh 
2064,KONUDULA VENKATA REDDY,Independent,103,1,104,0.05,Banaganapalle,140,Andhra Pradesh 
2065,GANGAVARAPU SIVA PRASAD,Independent,160,0,160,0.08,Banaganapalle,140,Andhra Pradesh 
2066,GUVVALA SUBBAREDDY,Independent,195,0,195,0.09,Banaganapalle,140,Andhra Pradesh 
2067,NARAHARISETTI RAVI,Independent,201,0,201,0.1,Banaganapalle,140,Andhra Pradesh 
2068,A. V. NAGI REDDY,Independent,554,0,554,0.27,Banaganapalle,140,Andhra Pradesh 
2069,Y. MADHU KRISHNA,Independent,573,0,573,0.28,Banaganapalle,140,Andhra Pradesh 
2070,MARAM SATYAM REDDY,Independent,366,0,366,0.18,Banaganapalle,140,Andhra Pradesh 
2071,G. MOHAN REDDY,Independent,294,0,294,0.14,Banaganapalle,140,Andhra Pradesh 
2072,RAGIMANU SANJEEVA KUMAR,Independent,289,0,289,0.14,Banaganapalle,140,Andhra Pradesh 
2073,M. RAMACHANDRA NAIK,Independent,100,0,100,0.05,Banaganapalle,140,Andhra Pradesh 
2074,Y. RAMACHANDRA REDDY,Independent,41,0,41,0.02,Banaganapalle,140,Andhra Pradesh 
2075,K. VENKATA SIVA REDDY,Independent,61,0,61,0.03,Banaganapalle,140,Andhra Pradesh 
2076,P. VENKATA SUBBAREDDY,Independent,58,0,58,0.03,Banaganapalle,140,Andhra Pradesh 
2077,U. SIVA NAGIREDDY,Independent,68,0,68,0.03,Banaganapalle,140,Andhra Pradesh 
2078,G. SESHASAYANA REDDY,Independent,79,0,79,0.04,Banaganapalle,140,Andhra Pradesh 
2079,T. V. SREENIVASULU,Independent,61,0,61,0.03,Banaganapalle,140,Andhra Pradesh 
2080,G. SUBBARAYUDU,Independent,165,0,165,0.08,Banaganapalle,140,Andhra Pradesh 
2081,NOTA,None of the Above,1516,12,1528,0.74,Banaganapalle,140,Andhra Pradesh 
2082,KOTLA JAYA SURYA PRAKASH REDDY,Telugu Desam,92421,1102,93523,49.19,Dhone,141,Andhra Pradesh 
2083,DR. GARLAPATI. MADDULETY SWAMY,Indian National Congress,3961,27,3988,2.1,Dhone,141,Andhra Pradesh 
2084,BUGGANA RAJA REDDY,Yuvajana Sramika Rythu Congress Party,86690,784,87474,46.01,Dhone,141,Andhra Pradesh 
2085,RUDRAVARAM G.RAMUDU,Bahujan Samaj Party,781,3,784,0.41,Dhone,141,Andhra Pradesh 
2086,TARIGOPULA BALU YADAV,Bharatha Chaitanya Yuvajana Party,116,0,116,0.06,Dhone,141,Andhra Pradesh 
2087,BALAPALA. KUMAR SWAMY,Jaathia Chethi Vruthula Ikya Vedika Party,91,0,91,0.05,Dhone,141,Andhra Pradesh 
2088,AKHIL KUMAR CHENNURU,Independent,182,2,184,0.1,Dhone,141,Andhra Pradesh 
2089,AVULA MAHESH YADAV,Independent,115,0,115,0.06,Dhone,141,Andhra Pradesh 
2090,J CHINNA JAYARAMUDU,Independent,70,2,72,0.04,Dhone,141,Andhra Pradesh 
2091,PEYITI ANAND,Independent,123,0,123,0.06,Dhone,141,Andhra Pradesh 
2092,POLUR. NAGENDRA BABU.,Independent,130,1,131,0.07,Dhone,141,Andhra Pradesh 
2093,PRASAD.,Independent,135,0,135,0.07,Dhone,141,Andhra Pradesh 
2094,K.RAVI KUMAR,Independent,187,0,187,0.1,Dhone,141,Andhra Pradesh 
2095,K. S. REDDY.,Independent,682,4,686,0.36,Dhone,141,Andhra Pradesh 
2096,M.V.REDDY,Independent,324,0,324,0.17,Dhone,141,Andhra Pradesh 
2097,C.S.C. REDDY,Independent,825,0,825,0.43,Dhone,141,Andhra Pradesh 
2098,NOTA,None of the Above,1351,11,1362,0.72,Dhone,141,Andhra Pradesh 
2099,KOTA. SRINIVAS RAO,Indian National Congress,1157,16,1173,0.67,Pattikonda,142,Andhra Pradesh 
2100,PILLI SURYA PRAKASH,Yuvajana Sramika Rythu Congress Party,70629,732,71361,40.69,Pattikonda,142,Andhra Pradesh 
2101,MATHA RANI SUBRAHMANYAM,Bahujan Samaj Party,1188,18,1206,0.69,Pattikonda,142,Andhra Pradesh 
2102,VASAMSETTI. SUBASH,Telugu Desam,96149,1503,97652,55.68,Pattikonda,142,Andhra Pradesh 
2103,JUTTUKA VENKATARAO,Pyramid Party of India,490,1,491,0.28,Pattikonda,142,Andhra Pradesh 
2104,BARLA SRINIVAS YADAV,Bharatha Chaitanya Yuvajana Party,92,1,93,0.05,Pattikonda,142,Andhra Pradesh 
2105,KATE SUBRAHMANYAM,Independent,52,1,53,0.03,Pattikonda,142,Andhra Pradesh 
2106,KOYYA BANGARU BABU,Independent,52,2,54,0.03,Pattikonda,142,Andhra Pradesh 
2107,CHANDRA SEKHAR MADIKI,Independent,78,0,78,0.04,Pattikonda,142,Andhra Pradesh 
2108,JHAI SREE SUREYENDRA NADHA BABUJI SREEGUTHULA,Independent,1070,9,1079,0.62,Pattikonda,142,Andhra Pradesh 
2109,YARRAMSETTI RAMARAJU,Independent,245,1,246,0.14,Pattikonda,142,Andhra Pradesh 
2110,LANKA. PRAVEEN KUMAR,Independent,121,1,122,0.07,Pattikonda,142,Andhra Pradesh 
2111,SUJATA CHEKKA,Independent,172,0,172,0.1,Pattikonda,142,Andhra Pradesh 
2112,NOTA,None of the Above,1595,13,1608,0.92,Pattikonda,142,Andhra Pradesh 
2113,AUDIMULAPU SATHISH,Yuvajana Sramika Rythu Congress Party,79418,702,80120,40.56,Kodumur (SC),143,Andhra Pradesh 
2114,JAIRAJ,Bahujan Samaj Party,1642,7,1649,0.83,Kodumur (SC),143,Andhra Pradesh 
2115,BOGGULA DASTAGIRI,Telugu Desam,100178,1525,101703,51.49,Kodumur (SC),143,Andhra Pradesh 
2116,P. MURALI KRISHNA,Indian National Congress,9728,107,9835,4.98,Kodumur (SC),143,Andhra Pradesh 
2117,ANDE MEENA KUMARI,Anna YSR Congress Party,230,5,235,0.12,Kodumur (SC),143,Andhra Pradesh 
2118,GADI DEVARAJU,Jai Bharat National Party,151,1,152,0.08,Kodumur (SC),143,Andhra Pradesh 
2119,POLUDASARI AYYASWAMY,Jaathia Chethi Vruthula Ikya Vedika Party,125,0,125,0.06,Kodumur (SC),143,Andhra Pradesh 
2120,MALLAPU RAJU,India Praja Bandhu Party,114,1,115,0.06,Kodumur (SC),143,Andhra Pradesh 
2121,MASTIK NADIPI GUNDALU,Yuga Thulasi Party,205,0,205,0.1,Kodumur (SC),143,Andhra Pradesh 
2122,KALABANDI CHANDRA SEKHAR,Independent,136,0,136,0.07,Kodumur (SC),143,Andhra Pradesh 
2123,DWARAM SATEESH,Independent,115,0,115,0.06,Kodumur (SC),143,Andhra Pradesh 
2124,E.BABY RADHA,Independent,303,1,304,0.15,Kodumur (SC),143,Andhra Pradesh 
2125,B. BHASKAR,Independent,299,0,299,0.15,Kodumur (SC),143,Andhra Pradesh 
2126,RAJU BANKA,Independent,371,0,371,0.19,Kodumur (SC),143,Andhra Pradesh 
2127,NOTA,None of the Above,2149,20,2169,1.1,Kodumur (SC),143,Andhra Pradesh 
2128,M.KHASIM VALI,Indian National Congress,7748,83,7831,3.86,Yemmiganur,144,Andhra Pradesh 
2129,B. JAYANAGESWARA REDDY,Telugu Desam,101212,1877,103089,50.76,Yemmiganur,144,Andhra Pradesh 
2130,BUTTA RENUKA,Yuvajana Sramika Rythu Congress Party,86396,856,87252,42.96,Yemmiganur,144,Andhra Pradesh 
2131,K. RAGHAVENDRA,Bahujan Samaj Party,884,9,893,0.44,Yemmiganur,144,Andhra Pradesh 
2132,K.NAGARJUNA AREDDY,Jatiya Jana Sena Party,181,3,184,0.09,Yemmiganur,144,Andhra Pradesh 
2133,GAVVALA NARAYANA,Independent,248,2,250,0.12,Yemmiganur,144,Andhra Pradesh 
2134,GOLLA EERANNA,Independent,134,1,135,0.07,Yemmiganur,144,Andhra Pradesh 
2135,JAGANNATHA ERANNA,Independent,225,0,225,0.11,Yemmiganur,144,Andhra Pradesh 
2136,RAJASEKHAR . MITTI,Independent,388,0,388,0.19,Yemmiganur,144,Andhra Pradesh 
2137,VIJAYA LAKSHMI. P,Independent,461,1,462,0.23,Yemmiganur,144,Andhra Pradesh 
2138,NOTA,None of the Above,2357,23,2380,1.17,Yemmiganur,144,Andhra Pradesh 
2139,GUDIPI SAMELU,Bahujan Samaj Party,3586,3,3589,2.04,Mantralayam,145,Andhra Pradesh 
2140,Y. BALANAGI REDDY,Yuvajana Sramika Rythu Congress Party,87411,251,87662,49.72,Mantralayam,145,Andhra Pradesh 
2141,P. S MURLI KRISHNARAJU DORA,Indian National Congress,4645,15,4660,2.64,Mantralayam,145,Andhra Pradesh 
2142,N. RAGHAVENDRA REDDY,Telugu Desam,74529,328,74857,42.45,Mantralayam,145,Andhra Pradesh 
2143,R. RAGHAVENDRA REDDY,Jatiya Jana Sena Party,606,2,608,0.34,Mantralayam,145,Andhra Pradesh 
2144,CHAKKERA PARAMESH VALMIKI,Independent,297,0,297,0.17,Mantralayam,145,Andhra Pradesh 
2145,K. NAGIREDDY,Independent,353,0,353,0.2,Mantralayam,145,Andhra Pradesh 
2146,M. RAGHAVENDRA REDDY,Independent,623,1,624,0.35,Mantralayam,145,Andhra Pradesh 
2147,NOTA,None of the Above,3669,5,3674,2.08,Mantralayam,145,Andhra Pradesh 
2148,ARAKATLA NAVEEN KISHOR,Indian National Congress,5751,21,5772,2.74,Alur,147,Andhra Pradesh 
2149,H. RAMALINGAIAH,Bahujan Samaj Party,1364,5,1369,0.65,Alur,147,Andhra Pradesh 
2150,B. VIRUPAKSHI,Yuvajana Sramika Rythu Congress Party,99785,479,100264,47.65,Alur,147,Andhra Pradesh 
2151,B. VEERABHADRA GOWD,Telugu Desam,96597,836,97433,46.3,Alur,147,Andhra Pradesh 
2152,N MOHAN PRASAD,Bharatha Chaitanya Yuvajana Party,673,1,674,0.32,Alur,147,Andhra Pradesh 
2153,SHAIK. SHAIKSHA VALI,Jai Bharat National Party,275,1,276,0.13,Alur,147,Andhra Pradesh 
2154,M. AMANULLA,Independent,227,0,227,0.11,Alur,147,Andhra Pradesh 
2155,ADONI ANJANEYULU,Independent,200,0,200,0.1,Alur,147,Andhra Pradesh 
2156,RANGASWAMY KAVALI,Independent,220,0,220,0.1,Alur,147,Andhra Pradesh 
2157,R. LOKANATH,Independent,282,0,282,0.13,Alur,147,Andhra Pradesh 
2158,B. SATYANNA,Independent,534,2,536,0.25,Alur,147,Andhra Pradesh 
2159,HEBBATAM VANNURAPPA,Independent,542,0,542,0.26,Alur,147,Andhra Pradesh 
2160,NOTA,None of the Above,2629,5,2634,1.25,Alur,147,Andhra Pradesh 
2161,KAMANA PRABHAKARA RAO,Indian National Congress,1450,34,1484,0.76,Rayadurg,148,Andhra Pradesh 
2162,GURRAPU KOTTIYYA,Bahujan Samaj Party,451,2,453,0.23,Rayadurg,148,Andhra Pradesh 
2163,JOGESWARA RAO.V,Telugu Desam,115088,1221,116309,59.94,Rayadurg,148,Andhra Pradesh 
2164,THOTA TRIMURTHULU,Yuvajana Sramika Rythu Congress Party,71086,788,71874,37.04,Rayadurg,148,Andhra Pradesh 
2165,NALLA CHINNA RAO,Liberation Congress Party,293,0,293,0.15,Rayadurg,148,Andhra Pradesh 
2166,NANDIKOLLA RAJU,Navataram Party,131,0,131,0.07,Rayadurg,148,Andhra Pradesh 
2167,SADEY. DAVID RAJU,Republican Party of India (A),118,2,120,0.06,Rayadurg,148,Andhra Pradesh 
2168,KONA SURYA BHASKARA RAO,Independent,103,0,103,0.05,Rayadurg,148,Andhra Pradesh 
2169,MANDAPALLI RAVI,Independent,100,1,101,0.05,Rayadurg,148,Andhra Pradesh 
2170,RAYUDU SRINIVASU,Independent,138,2,140,0.07,Rayadurg,148,Andhra Pradesh 
2171,VEERA VENKATA SATYANARAYANA KONA,Independent,157,0,157,0.08,Rayadurg,148,Andhra Pradesh 
2172,SRIKRISHNA KONA,Independent,151,1,152,0.08,Rayadurg,148,Andhra Pradesh 
2173,SATYANARAYANA MARNI,Independent,1148,13,1161,0.6,Rayadurg,148,Andhra Pradesh 
2174,NOTA,None of the Above,1541,27,1568,0.81,Rayadurg,148,Andhra Pradesh 
2175,ANKE THIPPESWAMY,Bahujan Samaj Party,3828,4,3832,1.97,Uravakonda,149,Andhra Pradesh 
2176,PAYYAVULA KESHAV,Telugu Desam,100550,1496,102046,52.46,Uravakonda,149,Andhra Pradesh 
2177,Y. MADHUSUDHAN REDDY,Indian National Congress,4485,44,4529,2.33,Uravakonda,149,Andhra Pradesh 
2178,Y. VISWESWARA REDDY,Yuvajana Sramika Rythu Congress Party,79746,596,80342,41.3,Uravakonda,149,Andhra Pradesh 
2179,KURUBA CHINNAKKA,All India Kisan Janatha party,353,2,355,0.18,Uravakonda,149,Andhra Pradesh 
2180,B. PAVAN KUMAR,Bharatha Chaitanya Yuvajana Party,155,3,158,0.08,Uravakonda,149,Andhra Pradesh 
2181,YARRANNA GARI RAMANJINEYALU,Jai Bharat National Party,176,1,177,0.09,Uravakonda,149,Andhra Pradesh 
2182,KARANAM BHARANGI MOHANDAS,Independent,177,1,178,0.09,Uravakonda,149,Andhra Pradesh 
2183,V. CHANDRASEKHAR REDDY,Independent,293,0,293,0.15,Uravakonda,149,Andhra Pradesh 
2184,K. DAMODAR REDDY,Independent,228,0,228,0.12,Uravakonda,149,Andhra Pradesh 
2185,VISWESWARAIAH,Independent,469,0,469,0.24,Uravakonda,149,Andhra Pradesh 
2186,NOTA,None of the Above,1900,15,1915,0.98,Uravakonda,149,Andhra Pradesh 
2187,GUMMANUR JAYARAM,Telugu Desam,99952,1748,101700,49.19,Guntakal,150,Andhra Pradesh 
2188,K. PRABHAKAR,Indian National Congress,5074,72,5146,2.49,Guntakal,150,Andhra Pradesh 
2189,Y. VENKATA RAMA REDDY,Yuvajana Sramika Rythu Congress Party,93856,1018,94874,45.89,Guntakal,150,Andhra Pradesh 
2190,SHAIK ABDUL MALIK,Bahujan Samaj Party,928,10,938,0.45,Guntakal,150,Andhra Pradesh 
2191,JANGAM KRISHNA,Samajwadi Party,126,2,128,0.06,Guntakal,150,Andhra Pradesh 
2192,M. SASHIBUSHAN REDDY,Bharatha Chaitanya Yuvajana Party,81,0,81,0.04,Guntakal,150,Andhra Pradesh 
2193,RAHIMA P,Jaibhim Rao Bharat Party,97,1,98,0.05,Guntakal,150,Andhra Pradesh 
2194,G.M. ARUN KUMAR,Independent,107,1,108,0.05,Guntakal,150,Andhra Pradesh 
2195,C. ADINARAYANA CHOWDARY,Independent,72,0,72,0.03,Guntakal,150,Andhra Pradesh 
2196,EDIGA PEDDA ANJANEYULU,Independent,118,0,118,0.06,Guntakal,150,Andhra Pradesh 
2197,M. KHAMAR BEGAM,Independent,118,1,119,0.06,Guntakal,150,Andhra Pradesh 
2198,BOYAGADDA ARUNAMMA,Independent,149,2,151,0.07,Guntakal,150,Andhra Pradesh 
2199,RABBONI VICTOR HATTIBELAGAL,Independent,265,0,265,0.13,Guntakal,150,Andhra Pradesh 
2200,SHAIK MAHABOOB BASHA,Independent,1180,10,1190,0.58,Guntakal,150,Andhra Pradesh 
2201,NOTA,None of the Above,1713,30,1743,0.84,Guntakal,150,Andhra Pradesh 
2202,ASHMIT REDDY J.C,Telugu Desam,112313,1442,113755,54.77,Tadpatri,151,Andhra Pradesh 
2203,KETHIREDDY PEDDAREDDY,Yuvajana Sramika Rythu Congress Party,85245,779,86024,41.42,Tadpatri,151,Andhra Pradesh 
2204,GUJJALA NAGIREDDY,Indian National Congress,2607,21,2628,1.27,Tadpatri,151,Andhra Pradesh 
2205,GANDIKOTA NAGA SUBBARAYUDU,Bahujan Samaj Party,415,5,420,0.2,Tadpatri,151,Andhra Pradesh 
2206,B.DHAKA RAJU,Bharatha Chaitanya Yuvajana Party,153,0,153,0.07,Tadpatri,151,Andhra Pradesh 
2207,DR. NALLANI.RAMESH NAIDU,Andhra Rastra Praja Samithi,778,6,784,0.38,Tadpatri,151,Andhra Pradesh 
2208,PALURU NEELAKANTA ACHARI,Jai Bharat National Party,129,1,130,0.06,Tadpatri,151,Andhra Pradesh 
2209,A D MAHABOOB BASHA,Samajwadi Party,75,0,75,0.04,Tadpatri,151,Andhra Pradesh 
2210,NEELURI RUSHINGAPPA,Jaathia Chethi Vruthula Ikya Vedika Party,104,1,105,0.05,Tadpatri,151,Andhra Pradesh 
2211,Y. VEERA NAGARAJU,Jaibhim Rao Bharat Party,130,2,132,0.06,Tadpatri,151,Andhra Pradesh 
2212,SIDDAVATAM SAI RAM REDDY,Rashtriya Samaj Dal (R),98,0,98,0.05,Tadpatri,151,Andhra Pradesh 
2213,AKULA NAGARAJU,Independent,115,0,115,0.06,Tadpatri,151,Andhra Pradesh 
2214,S.KAMBAGIRI RAMUDU,Independent,138,0,138,0.07,Tadpatri,151,Andhra Pradesh 
2215,CHANDRA OBUL REDDY R,Independent,107,0,107,0.05,Tadpatri,151,Andhra Pradesh 
2216,PEDDI REDDY L,Independent,243,1,244,0.12,Tadpatri,151,Andhra Pradesh 
2217,C. RAMA BAYAPA REDDY,Independent,636,0,636,0.31,Tadpatri,151,Andhra Pradesh 
2218,RAMINENI RAMAMOHAN,Independent,752,0,752,0.36,Tadpatri,151,Andhra Pradesh 
2219,SOMASEKHAR NAIDU PARIMI,Independent,383,0,383,0.18,Tadpatri,151,Andhra Pradesh 
2220,NOTA,None of the Above,983,17,1000,0.48,Tadpatri,151,Andhra Pradesh 
2221,KUNDANAM GOWTHAMI,Bahujan Samaj Party,3890,6,3896,1.87,Singanamala (SC),152,Andhra Pradesh 
2222,BANDARU SRAVANI SREE,Telugu Desam,101779,1178,102957,49.44,Singanamala (SC),152,Andhra Pradesh 
2223,M.VEERANJANEYULU,Yuvajana Sramika Rythu Congress Party,93551,618,94169,45.22,Singanamala (SC),152,Andhra Pradesh 
2224,DR. SAKE SAILAJANATH,Indian National Congress,3426,43,3469,1.67,Singanamala (SC),152,Andhra Pradesh 
2225,KAPPALA NAGARAJU,All India Kisan Janatha party,225,2,227,0.11,Singanamala (SC),152,Andhra Pradesh 
2226,G. RAMANJINEYULU,Jaibhim Rao Bharat Party,167,1,168,0.08,Singanamala (SC),152,Andhra Pradesh 
2227,VENKATA SUBBANNA YATA,Telugu Rajadhikara Samiti Party,157,0,157,0.08,Singanamala (SC),152,Andhra Pradesh 
2228,SAKE SREEDEVI,Jai Maha Bharath Party,110,0,110,0.05,Singanamala (SC),152,Andhra Pradesh 
2229,ANAND KUMAR. M,Independent,87,0,87,0.04,Singanamala (SC),152,Andhra Pradesh 
2230,KAYALA RAMA MOHAN,Independent,96,1,97,0.05,Singanamala (SC),152,Andhra Pradesh 
2231,KODAMALA OBULESU,Independent,142,0,142,0.07,Singanamala (SC),152,Andhra Pradesh 
2232,MANNEPAKULA MADHAVA,Independent,230,0,230,0.11,Singanamala (SC),152,Andhra Pradesh 
2233,MIDDE NALLAPPA,Independent,229,0,229,0.11,Singanamala (SC),152,Andhra Pradesh 
2234,V. SAI PRASAD,Independent,389,0,389,0.19,Singanamala (SC),152,Andhra Pradesh 
2235,NOTA,None of the Above,1899,7,1906,0.92,Singanamala (SC),152,Andhra Pradesh 
2236,AMILINENI SURENDRA BABU,Telugu Desam,117364,1514,118878,57.75,Kalyandurg,154,Andhra Pradesh 
2237,TALARI RANGAIAH,Yuvajana Sramika Rythu Congress Party,80353,791,81144,39.42,Kalyandurg,154,Andhra Pradesh 
2238,PERAMNETI RAMBHUPAL REDDY,Indian National Congress,2557,28,2585,1.26,Kalyandurg,154,Andhra Pradesh 
2239,HARIJANA NAGAMMA,Bahujan Samaj Party,434,6,440,0.21,Kalyandurg,154,Andhra Pradesh 
2240,BANGARU GIRIPRASAD REDDY,Andhra Rastra Praja Samithi,120,0,120,0.06,Kalyandurg,154,Andhra Pradesh 
2241,P.M.LAKSHMANA MURTHY,Jai Bharat National Party,135,0,135,0.07,Kalyandurg,154,Andhra Pradesh 
2242,HARIJANA VENKATESULU,Jaibhim Rao Bharat Party,135,0,135,0.07,Kalyandurg,154,Andhra Pradesh 
2243,KURUBA MUKKANNA,Independent,100,0,100,0.05,Kalyandurg,154,Andhra Pradesh 
2244,GANGURI SURESH,Independent,81,0,81,0.04,Kalyandurg,154,Andhra Pradesh 
2245,T. VISWANATH,Independent,84,0,84,0.04,Kalyandurg,154,Andhra Pradesh 
2246,NANEVATH BALARAM NAIK,Independent,96,2,98,0.05,Kalyandurg,154,Andhra Pradesh 
2247,BALIJA LAKSHMI NARAYANA,Independent,110,0,110,0.05,Kalyandurg,154,Andhra Pradesh 
2248,MEENUGA ASHOK,Independent,97,0,97,0.05,Kalyandurg,154,Andhra Pradesh 
2249,RAMESH EGITI,Independent,137,0,137,0.07,Kalyandurg,154,Andhra Pradesh 
2250,SREERANGARAJULA GOPINATH ROYAL,Independent,247,0,247,0.12,Kalyandurg,154,Andhra Pradesh 
2251,NOTA,None of the Above,1442,8,1450,0.7,Kalyandurg,154,Andhra Pradesh 
2252,ADI ANDHRA SAKE SANKARAIAH,Indian National Congress,3421,35,3456,1.59,Raptadu,155,Andhra Pradesh 
2253,M ANJAIAH,Bahujan Samaj Party,811,4,815,0.38,Raptadu,155,Andhra Pradesh 
2254,THOPUDURTHI PRAKASH REDDY,Yuvajana Sramika Rythu Congress Party,91538,1273,92811,42.74,Raptadu,155,Andhra Pradesh 
2255,PARITALA SUNITHAMMA,Telugu Desam,113734,2406,116140,53.48,Raptadu,155,Andhra Pradesh 
2256,KURUBA S MALLIKARJUNA,All India Kisan Janatha party,307,1,308,0.14,Raptadu,155,Andhra Pradesh 
2257,B NARESH S/O B NARAYANA,Navataram Party,692,6,698,0.32,Raptadu,155,Andhra Pradesh 
2258,K NARESH S/O PEDDA YALLAPPA KODAVANDLA,Jaibhim Rao Bharat Party,69,0,69,0.03,Raptadu,155,Andhra Pradesh 
2259,KANAGALA VIJAY KUMAR,Independent,39,1,40,0.02,Raptadu,155,Andhra Pradesh 
2260,MANLU KOSE RAMANJI,Independent,88,0,88,0.04,Raptadu,155,Andhra Pradesh 
2261,E RAVI VARMA,Independent,95,0,95,0.04,Raptadu,155,Andhra Pradesh 
2262,Y RAJASEKHAR,Independent,139,0,139,0.06,Raptadu,155,Andhra Pradesh 
2263,C VENKATA RAMUDU,Independent,217,0,217,0.1,Raptadu,155,Andhra Pradesh 
2264,SAKE RAJESH KUMAR,Independent,564,11,575,0.26,Raptadu,155,Andhra Pradesh 
2265,NOTA,None of the Above,1670,36,1706,0.79,Raptadu,155,Andhra Pradesh 
2266,D.INDEEVAR,Bahujan Samaj Party,3742,4,3746,2.01,Madakasira (SC),156,Andhra Pradesh 
2267,IRALAKKAPPA.S.L,Yuvajana Sramika Rythu Congress Party,79148,484,79632,42.78,Madakasira (SC),156,Andhra Pradesh 
2268,M.S.RAJU,Telugu Desam,79244,739,79983,42.97,Madakasira (SC),156,Andhra Pradesh 
2269,K.SUDHAKAR,Indian National Congress,17036,344,17380,9.34,Madakasira (SC),156,Andhra Pradesh 
2270,PARADESANNA GARI HANUMANTHARAJU,Radical Party of India (Ambedkarist),275,0,275,0.15,Madakasira (SC),156,Andhra Pradesh 
2271,B.KARININGAPPA,Independent,103,0,103,0.06,Madakasira (SC),156,Andhra Pradesh 
2272,R.GURUMURTHY,Independent,128,0,128,0.07,Madakasira (SC),156,Andhra Pradesh 
2273,T.DHANARAJ,Independent,860,5,865,0.46,Madakasira (SC),156,Andhra Pradesh 
2274,R.G.PAVITHRA,Independent,300,0,300,0.16,Madakasira (SC),156,Andhra Pradesh 
2275,K.RAVEENDRA,Independent,113,1,114,0.06,Madakasira (SC),156,Andhra Pradesh 
2276,M.RAJANNA,Independent,163,3,166,0.09,Madakasira (SC),156,Andhra Pradesh 
2277,M.LAKSHMINARASAPPA,Independent,308,2,310,0.17,Madakasira (SC),156,Andhra Pradesh 
2278,HALLIKERA JAGANNATHA PRASAD,Independent,401,7,408,0.22,Madakasira (SC),156,Andhra Pradesh 
2279,NOTA,None of the Above,2720,8,2728,1.47,Madakasira (SC),156,Andhra Pradesh 
2280,M H ENAYATHULLA,Indian National Congress,8894,64,8958,4.57,Hindupur,157,Andhra Pradesh 
2281,DEEPIKA T N,Yuvajana Sramika Rythu Congress Party,74176,477,74653,38.1,Hindupur,157,Andhra Pradesh 
2282,NANDAMURI BALAKRISHNA,Telugu Desam,105778,1472,107250,54.73,Hindupur,157,Andhra Pradesh 
2283,M SREERAMULU,Bahujan Samaj Party,644,2,646,0.33,Hindupur,157,Andhra Pradesh 
2284,KODUMURU NOUSHAD,Andhra Pradesh Rashtra Samithi,161,1,162,0.08,Hindupur,157,Andhra Pradesh 
2285,G.NAGARAJU,Jaibhim Rao Bharat Party,162,1,163,0.08,Hindupur,157,Andhra Pradesh 
2286,V.RAVINDRA,Socialist Unity Centre Of India (COMMUNIST),111,2,113,0.06,Hindupur,157,Andhra Pradesh 
2287,SHAIK SHOUKATH,Samajwadi Party,130,1,131,0.07,Hindupur,157,Andhra Pradesh 
2288,MOHAMED GOUS,Independent,94,0,94,0.05,Hindupur,157,Andhra Pradesh 
2289,G.LOKENDRANATH,Independent,125,1,126,0.06,Hindupur,157,Andhra Pradesh 
2290,K.SAI NANDI,Independent,111,0,111,0.06,Hindupur,157,Andhra Pradesh 
2291,SWAMI PARIPOORNANANDA SARASWATHI,Independent,1475,37,1512,0.77,Hindupur,157,Andhra Pradesh 
2292,SUMALATHA MADANNA GARI R,Independent,356,0,356,0.18,Hindupur,157,Andhra Pradesh 
2293,NOTA,None of the Above,1676,10,1686,0.86,Hindupur,157,Andhra Pradesh 
2294,M ADINARAYANA,Bahujan Samaj Party,6193,8,6201,2.99,Penukonda,158,Andhra Pradesh 
2295,K.V. USHA SHRICHARAN,Yuvajana Sramika Rythu Congress Party,79795,649,80444,38.75,Penukonda,158,Andhra Pradesh 
2296,PURROLLA NARASIMHAPPA,Indian National Congress,3988,19,4007,1.93,Penukonda,158,Andhra Pradesh 
2297,S. SAVITHA,Telugu Desam,111960,1872,113832,54.83,Penukonda,158,Andhra Pradesh 
2298,N NAGARAJU,Jaibhim Rao Bharat Party,411,2,413,0.2,Penukonda,158,Andhra Pradesh 
2299,NARASIMHULU.A,Independent,135,0,135,0.07,Penukonda,158,Andhra Pradesh 
2300,B. MAHESH,Independent,188,0,188,0.09,Penukonda,158,Andhra Pradesh 
2301,SUGALI GANESH NAIK,Independent,171,0,171,0.08,Penukonda,158,Andhra Pradesh 
2302,HABEEB,Independent,251,1,252,0.12,Penukonda,158,Andhra Pradesh 
2303,NOTA,None of the Above,1956,16,1972,0.95,Penukonda,158,Andhra Pradesh 
2304,AMPAVATHINI GOVINDHU,Bahujan Samaj Party,3805,6,3811,2.07,Puttaparthi,159,Andhra Pradesh 
2305,DAADHI REDDY MADUSUDHAN REDDY,Indian National Congress,1977,20,1997,1.09,Puttaparthi,159,Andhra Pradesh 
2306,DUDDUKUNTA SREEDHAR REDDY,Yuvajana Sramika Rythu Congress Party,82216,765,82981,45.1,Puttaparthi,159,Andhra Pradesh 
2307,PALLE SINDHURA REDDY,Telugu Desam,90173,1568,91741,49.87,Puttaparthi,159,Andhra Pradesh 
2308,KARAMSI BALAJI NAIK,Jai Bharat National Party,361,1,362,0.2,Puttaparthi,159,Andhra Pradesh 
2309,BALA RAMANJINEYULU,Bharatha Chaitanya Yuvajana Party,124,1,125,0.07,Puttaparthi,159,Andhra Pradesh 
2310,U. ADBUL KHADER,Independent,189,0,189,0.1,Puttaparthi,159,Andhra Pradesh 
2311,KADIRISANI VENU GOPAL,Independent,121,1,122,0.07,Puttaparthi,159,Andhra Pradesh 
2312,K. K. KUMAR,Independent,75,0,75,0.04,Puttaparthi,159,Andhra Pradesh 
2313,T. NARAYANA SWAMI,Independent,163,0,163,0.09,Puttaparthi,159,Andhra Pradesh 
2314,PETLA SUDHAKAR,Independent,61,1,62,0.03,Puttaparthi,159,Andhra Pradesh 
2315,MAYAKUNTLA VENKATESH,Independent,102,0,102,0.06,Puttaparthi,159,Andhra Pradesh 
2316,RAGHUNATHA REDDY AOUK,Independent,220,1,221,0.12,Puttaparthi,159,Andhra Pradesh 
2317,RAMAVATH RANGANATH NAIK,Independent,331,1,332,0.18,Puttaparthi,159,Andhra Pradesh 
2318,M. SURESH,Independent,310,0,310,0.17,Puttaparthi,159,Andhra Pradesh 
2319,NOTA,None of the Above,1372,10,1382,0.75,Puttaparthi,159,Andhra Pradesh 
2320,KETHIREDDY VENKATA RAMI REDDY,Yuvajana Sramika Rythu Congress Party,101983,827,102810,46.76,Dharmavaram,160,Andhra Pradesh 
2321,RANGANA ASWARTHA NARAYANA,Indian National Congress,3722,36,3758,1.71,Dharmavaram,160,Andhra Pradesh 
2322,VINAY KUMAR SAKE,Bahujan Samaj Party,1089,6,1095,0.5,Dharmavaram,160,Andhra Pradesh 
2323,SATYA KUMAR YADAV,Bharatiya Janata Party,104957,1587,106544,48.46,Dharmavaram,160,Andhra Pradesh 
2324,DARA SHANKAR,Jaibhim Rao Bharat Party,616,0,616,0.28,Dharmavaram,160,Andhra Pradesh 
2325,SHEK AYAZ,Navataram Party,1146,9,1155,0.53,Dharmavaram,160,Andhra Pradesh 
2326,ILIYAZ AHMMAD SAYYAD,Independent,132,0,132,0.06,Dharmavaram,160,Andhra Pradesh 
2327,MACHIREDDY GARI ESWAR REDDY,Independent,98,0,98,0.04,Dharmavaram,160,Andhra Pradesh 
2328,J SURYA NARAYANA,Independent,73,0,73,0.03,Dharmavaram,160,Andhra Pradesh 
2329,DASARI KAVITHA,Independent,181,3,184,0.08,Dharmavaram,160,Andhra Pradesh 
2330,N DHANUNJAYA,Independent,131,0,131,0.06,Dharmavaram,160,Andhra Pradesh 
2331,BILLE NARENDRA,Independent,137,0,137,0.06,Dharmavaram,160,Andhra Pradesh 
2332,BEERE SOMA SEKHAR,Independent,249,2,251,0.11,Dharmavaram,160,Andhra Pradesh 
2333,RAVINDRA REDDY NAGU,Independent,611,0,611,0.28,Dharmavaram,160,Andhra Pradesh 
2334,D SREERAMULU NAIK,Independent,465,1,466,0.21,Dharmavaram,160,Andhra Pradesh 
2335,NOTA,None of the Above,1767,20,1787,0.81,Dharmavaram,160,Andhra Pradesh 
2336,KANDIKUNTA VENKATA PRASAD,Telugu Desam,101191,2419,103610,49.54,Kadiri ,161,Andhra Pradesh 
2337,MAQBOOL B.S.,Yuvajana Sramika Rythu Congress Party,96229,1116,97345,46.54,Kadiri ,161,Andhra Pradesh 
2338,Y. RAMACHANDRA,Bahujan Samaj Party,935,2,937,0.45,Kadiri ,161,Andhra Pradesh 
2339,K.S. SHANWAZ,Indian National Congress,3269,45,3314,1.58,Kadiri ,161,Andhra Pradesh 
2340,M. RAJENDRA,Pyramid Party of India,171,2,173,0.08,Kadiri ,161,Andhra Pradesh 
2341,SHREESAILAM MURALI,Radical Party of India (Ambedkarist),77,1,78,0.04,Kadiri ,161,Andhra Pradesh 
2342,KADIRISANI ESWARAIAH,Independent,93,1,94,0.04,Kadiri ,161,Andhra Pradesh 
2343,G. KHAJAMAINUDDIN,Independent,117,0,117,0.06,Kadiri ,161,Andhra Pradesh 
2344,TAMMUTA SURESH,Independent,98,0,98,0.05,Kadiri ,161,Andhra Pradesh 
2345,PONTHALA PALAKONDAMA NAIDU,Independent,141,2,143,0.07,Kadiri ,161,Andhra Pradesh 
2346,BANOTH SURESH NAIK,Independent,105,2,107,0.05,Kadiri ,161,Andhra Pradesh 
2347,S. MAKBUL BASHA,Independent,227,1,228,0.11,Kadiri ,161,Andhra Pradesh 
2348,YADALLA RAJESH KUMAR,Independent,389,0,389,0.19,Kadiri ,161,Andhra Pradesh 
2349,NOTA,None of the Above,2497,22,2519,1.2,Kadiri ,161,Andhra Pradesh 
2350,K. SUJATHA,Bahujan Samaj Party,737,1,738,0.39,Thamballapalle ,162,Andhra Pradesh 
2351,M.N. CHANDRA SHEKAR REDDY,Indian National Congress,3418,26,3444,1.83,Thamballapalle ,162,Andhra Pradesh 
2352,D. JAYACHANDRA REDDY,Telugu Desam,82947,1086,84033,44.73,Thamballapalle ,162,Andhra Pradesh 
2353,P. DWARAKANATHA REDDY,Yuvajana Sramika Rythu Congress Party,93416,720,94136,50.11,Thamballapalle ,162,Andhra Pradesh 
2354,ANJALI PEETLARAJANALA,Jai Bharat National Party,630,7,637,0.34,Thamballapalle ,162,Andhra Pradesh 
2355,D. JAYA CHANDRA REDDY,Jatiya Jana Sena Party,300,2,302,0.16,Thamballapalle ,162,Andhra Pradesh 
2356,GUNDALA KRISHNAPPA,Independent,343,0,343,0.18,Thamballapalle ,162,Andhra Pradesh 
2357,Y.DWARAKANATHA REDDY,Independent,304,1,305,0.16,Thamballapalle ,162,Andhra Pradesh 
2358,N. NARASIMHULU,Independent,266,0,266,0.14,Thamballapalle ,162,Andhra Pradesh 
2359,P.V. VENKATAREDDY,Independent,475,0,475,0.25,Thamballapalle ,162,Andhra Pradesh 
2360,M. SURESH,Independent,801,2,803,0.43,Thamballapalle ,162,Andhra Pradesh 
2361,NOTA,None of the Above,2373,11,2384,1.27,Thamballapalle ,162,Andhra Pradesh 
2362,CHINTHALA RAMACHANDRA REDDY,Yuvajana Sramika Rythu Congress Party,79498,1003,80501,41.55,Pileru,163,Andhra Pradesh 
2363,NALLARI KISHAN KUMAR REDDY,Telugu Desam,103136,2446,105582,54.5,Pileru,163,Andhra Pradesh 
2364,BALIREDDY SOMASHEKAR REDDY,Indian National Congress,3367,36,3403,1.76,Pileru,163,Andhra Pradesh 
2365,M.C. VENKATARAMANA,Bahujan Samaj Party,490,8,498,0.26,Pileru,163,Andhra Pradesh 
2366,G. ANKALESWARI,Ambedkar National Congress,231,1,232,0.12,Pileru,163,Andhra Pradesh 
2367,M. VIJAY KUMAR,Jai Maha Bharath Party,96,0,96,0.05,Pileru,163,Andhra Pradesh 
2368,ASADI VENKATADRI,Independent,97,0,97,0.05,Pileru,163,Andhra Pradesh 
2369,K. CHINNA REDDEPPA REDDY,Independent,153,0,153,0.08,Pileru,163,Andhra Pradesh 
2370,K. BRAHMAIAH ACHARI,Independent,622,0,622,0.32,Pileru,163,Andhra Pradesh 
2371,V.MANJUNATH,Independent,183,2,185,0.1,Pileru,163,Andhra Pradesh 
2372,Y. MAHESH REDDY,Independent,173,1,174,0.09,Pileru,163,Andhra Pradesh 
2373,P. RAMA KRISHNA REDDY,Independent,329,0,329,0.17,Pileru,163,Andhra Pradesh 
2374,NOTA,None of the Above,1857,12,1869,0.96,Pileru,163,Andhra Pradesh 
2375,NARASIMHULU RASINTHI,Bahujan Samaj Party,1204,16,1220,0.6,Madanapalle,164,Andhra Pradesh 
2376,S.NISAR AHAMAD,Yuvajana Sramika Rythu Congress Party,91626,845,92471,45.58,Madanapalle,164,Andhra Pradesh 
2377,MALLELA PAVAN KUMAR REDDY,Indian National Congress,5940,111,6051,2.98,Madanapalle,164,Andhra Pradesh 
2378,M.SHAJAHAN BASHA,Telugu Desam,95745,2235,97980,48.3,Madanapalle,164,Andhra Pradesh 
2379,ADIVIPALLE KRISHNAPPA,Pyramid Party of India,304,1,305,0.15,Madanapalle,164,Andhra Pradesh 
2380,M.BHASKAR,Jai Bharat National Party,152,1,153,0.08,Madanapalle,164,Andhra Pradesh 
2381,NARRAVULA MANI SANKAR,Jaathia Chethi Vruthula Ikya Vedika Party,121,0,121,0.06,Madanapalle,164,Andhra Pradesh 
2382,V.UMADEVI,Independent,210,3,213,0.1,Madanapalle,164,Andhra Pradesh 
2383,M.GULNAZ BEGUM,Independent,142,0,142,0.07,Madanapalle,164,Andhra Pradesh 
2384,S.JAYASIMHA,Independent,185,1,186,0.09,Madanapalle,164,Andhra Pradesh 
2385,SHAIK NISAR AHAMAD,Independent,475,4,479,0.24,Madanapalle,164,Andhra Pradesh 
2386,B.NARASIMHA NAIK,Independent,121,1,122,0.06,Madanapalle,164,Andhra Pradesh 
2387,RAYADURGAM JANARDHANA,Independent,137,1,138,0.07,Madanapalle,164,Andhra Pradesh 
2388,S.SAJAHAN,Independent,1280,8,1288,0.63,Madanapalle,164,Andhra Pradesh 
2389,SHAIK AZID BASHA,Independent,242,1,243,0.12,Madanapalle,164,Andhra Pradesh 
2390,NOTA,None of the Above,1732,27,1759,0.87,Madanapalle,164,Andhra Pradesh 
2391,CHALLA RAMACHANDRA REDDY,Telugu Desam,93155,1543,94698,45.16,Punganur,165,Andhra Pradesh 
2392,PEDDIREDDI RAMACHANDRA REDDY,Yuvajana Sramika Rythu Congress Party,99774,1019,100793,48.07,Punganur,165,Andhra Pradesh 
2393,G MURALI MOHAN YADAV,Indian National Congress,3546,25,3571,1.7,Punganur,165,Andhra Pradesh 
2394,VASANTHAPALLI SURESH,Bahujan Samaj Party,679,8,687,0.33,Punganur,165,Andhra Pradesh 
2395,K S ANWAR BASHA,Social Democratic Party Of India,1894,12,1906,0.91,Punganur,165,Andhra Pradesh 
2396,BODE RAMACHANDRA YADAV,Bharatha Chaitanya Yuvajana Party,4423,136,4559,2.17,Punganur,165,Andhra Pradesh 
2397,I NAGESWAR RAO,Independent,242,0,242,0.12,Punganur,165,Andhra Pradesh 
2398,G RAMAIAH,Independent,314,0,314,0.15,Punganur,165,Andhra Pradesh 
2399,NOTA,None of the Above,2884,20,2904,1.39,Punganur,165,Andhra Pradesh 
2400,CHEVIREDDY MOHITH REDDY,Yuvajana Sramika Rythu Congress Party,98304,1511,99815,39.1,Chandragiri ,166,Andhra Pradesh 
2401,VENKATA MANI PRASAD PULLIVARTHI,Telugu Desam,140861,2806,143667,56.29,Chandragiri ,166,Andhra Pradesh 
2402,K SRINIVASULU,Indian National Congress,2957,14,2971,1.16,Chandragiri ,166,Andhra Pradesh 
2403,P.KARTHIK,Jatiya Jana Sena Party,741,3,744,0.29,Chandragiri ,166,Andhra Pradesh 
2404,K ESWARAIAH,Liberation Congress Party,227,1,228,0.09,Chandragiri ,166,Andhra Pradesh 
2405,THURAKA AMARANATH,Jai Bharat National Party,146,4,150,0.06,Chandragiri ,166,Andhra Pradesh 
2406,L.PRASAD,Jaathia Chethi Vruthula Ikya Vedika Party,115,0,115,0.05,Chandragiri ,166,Andhra Pradesh 
2407,MAHESH BABU MALLELA,Revolutionary Socialist Party,286,0,286,0.11,Chandragiri ,166,Andhra Pradesh 
2408,M.NEELAKANTA,Jai Hindustan Party,121,0,121,0.05,Chandragiri ,166,Andhra Pradesh 
2409,MOHAN DILEEP KUMAR,United Republican Party of India,91,0,91,0.04,Chandragiri ,166,Andhra Pradesh 
2410,PATHIPUTTURU VISWANATHA REDDY,Naba Bharata Nirmana Seva Party,75,0,75,0.03,Chandragiri ,166,Andhra Pradesh 
2411,DUDEKULA ALTAF,Independent,96,1,97,0.04,Chandragiri ,166,Andhra Pradesh 
2412,EDDALA SRINATH,Independent,139,0,139,0.05,Chandragiri ,166,Andhra Pradesh 
2413,C.N.SARAVANAA,Independent,177,5,182,0.07,Chandragiri ,166,Andhra Pradesh 
2414,T.GOWTHAMA RAO,Independent,339,13,352,0.14,Chandragiri ,166,Andhra Pradesh 
2415,C PAYANI,Independent,594,0,594,0.23,Chandragiri ,166,Andhra Pradesh 
2416,AKKILIGUNTA MADHU,Independent,693,0,693,0.27,Chandragiri ,166,Andhra Pradesh 
2417,K RAJESH,Independent,762,0,762,0.3,Chandragiri ,166,Andhra Pradesh 
2418,RAMBABU DASARI,Independent,138,0,138,0.05,Chandragiri ,166,Andhra Pradesh 
2419,P.VENKATAKRISHNA MURTHY,Independent,2014,8,2022,0.79,Chandragiri ,166,Andhra Pradesh 
2420,P.SREEDHAR,Independent,68,0,68,0.03,Chandragiri ,166,Andhra Pradesh 
2421,K.SAI CHANDRIKA,Independent,71,0,71,0.03,Chandragiri ,166,Andhra Pradesh 
2422,S.RAJASEKHAR,Independent,54,0,54,0.02,Chandragiri ,166,Andhra Pradesh 
2423,HARI RAM VADRAYALA,Independent,114,0,114,0.04,Chandragiri ,166,Andhra Pradesh 
2424,NOTA,None of the Above,1669,31,1700,0.67,Chandragiri ,166,Andhra Pradesh 
2425,BHUMANA ABHINAY,Yuvajana Sramika Rythu Congress Party,60950,1201,62151,32.08,Tirupati,167,Andhra Pradesh 
2426,PENCHALA PRASAD VASILI,Independent,258,0,258,0.13,Tirupati,167,Andhra Pradesh 
2427,R KRISHNA CHAITANYA,Independent,43,1,44,0.02,Tirupati,167,Andhra Pradesh 
2428,BANDLA CHANDRASEKHAR,Independent,97,0,97,0.05,Tirupati,167,Andhra Pradesh 
2429,NAVEN BRUNGI,Independent,30,0,30,0.02,Tirupati,167,Andhra Pradesh 
2430,PAPIREDDYGARI SOMASEKHAR REDDY,Independent,199,0,199,0.1,Tirupati,167,Andhra Pradesh 
2431,SODISETTY NARESH,Independent,26,0,26,0.01,Tirupati,167,Andhra Pradesh 
2432,LAKSHMI L. N.,Socialist Unity Centre Of India (COMMUNIST),107,0,107,0.06,Tirupati,167,Andhra Pradesh 
2433,KANTHA RAO K,Independent,54,1,55,0.03,Tirupati,167,Andhra Pradesh 
2434,MURALI P,Communist Party of India,597,11,608,0.31,Tirupati,167,Andhra Pradesh 
2435,M. NEELAKANTA,Jai Hindustan Party,45,2,47,0.02,Tirupati,167,Andhra Pradesh 
2436,K BHARGAV,Independent,216,0,216,0.11,Tirupati,167,Andhra Pradesh 
2437,NELLEPALLI BENARJI,Independent,251,0,251,0.13,Tirupati,167,Andhra Pradesh 
2438,P. SAI PRASANNA KUMAR,Independent,27,0,27,0.01,Tirupati,167,Andhra Pradesh 
2439,J VENUGOPAL RAJU,Bahujan Samaj Party,634,27,661,0.34,Tirupati,167,Andhra Pradesh 
2440,AKKIPALLI MUNI KRISHNAIAH,Independent,361,6,367,0.19,Tirupati,167,Andhra Pradesh 
2441,SHAIK MOHAMMED GOUSE,Independent,33,0,33,0.02,Tirupati,167,Andhra Pradesh 
2442,R. JYOTHI,Independent,37,0,37,0.02,Tirupati,167,Andhra Pradesh 
2443,RANGOON SANKAR,Independent,37,0,37,0.02,Tirupati,167,Andhra Pradesh 
2444,ARANII SRENEVASULU,Janasena Party,121205,2902,124107,64.06,Tirupati,167,Andhra Pradesh 
2445,UTUKURU SUBRAMANYAM,Independent,210,0,210,0.11,Tirupati,167,Andhra Pradesh 
2446,AKKIPALLI KRISHNAVENI YADAV,Bharatha Chaitanya Yuvajana Party,180,5,185,0.1,Tirupati,167,Andhra Pradesh 
2447,G REKHA,Independent,45,0,45,0.02,Tirupati,167,Andhra Pradesh 
2448,T TIRUMALA,Independent,31,1,32,0.02,Tirupati,167,Andhra Pradesh 
2449,C.N. SARAVANA,Independent,99,0,99,0.05,Tirupati,167,Andhra Pradesh 
2450,P BABU RAJENDRA PRASAD,Akhil Bharatiya Jan Sangh,50,2,52,0.03,Tirupati,167,Andhra Pradesh 
2451,RAVILLA MANJULA,Pyramid Party of India,105,0,105,0.05,Tirupati,167,Andhra Pradesh 
2452,SRINIVAS KUMAR GORLA,Samajwadi Party,40,0,40,0.02,Tirupati,167,Andhra Pradesh 
2453,T. JAYA KUMAR,Andhra Rastra Praja Samithi,76,0,76,0.04,Tirupati,167,Andhra Pradesh 
2454,VASAGIRI VENUGOPAL,Nava Socialism Party,70,3,73,0.04,Tirupati,167,Andhra Pradesh 
2455,AKKIPALLI ESWARAIAH,Independent,512,1,513,0.26,Tirupati,167,Andhra Pradesh 
2456,A. SATHYAVATHI,Independent,24,0,24,0.01,Tirupati,167,Andhra Pradesh 
2457,GOPI PRASAD .G,Independent,50,0,50,0.03,Tirupati,167,Andhra Pradesh 
2458,V. R. SURESH BABU,National Maha Sabha Party,148,0,148,0.08,Tirupati,167,Andhra Pradesh 
2459,M VIJAYA BABU,Reforms Party of India,49,0,49,0.03,Tirupati,167,Andhra Pradesh 
2460,G MURALI KRISHNA NAIDU,Jai Bharat National Party,58,2,60,0.03,Tirupati,167,Andhra Pradesh 
2461,SRINIVASULU ALURI,Jatiya Jana Sena Party,930,8,938,0.48,Tirupati,167,Andhra Pradesh 
2462,C MADHAVAN,Independent,123,0,123,0.06,Tirupati,167,Andhra Pradesh 
2463,S.VASUDEVA REDDY,Independent,21,2,23,0.01,Tirupati,167,Andhra Pradesh 
2464,A. SHIVA KUMAR,Independent,24,0,24,0.01,Tirupati,167,Andhra Pradesh 
2465,KAYAM VENKATARATHNAM,Independent,42,0,42,0.02,Tirupati,167,Andhra Pradesh 
2466,SYED GHOUSE,Independent,23,0,23,0.01,Tirupati,167,Andhra Pradesh 
2467,M JAGADEESH,Independent,34,0,34,0.02,Tirupati,167,Andhra Pradesh 
2468,THOTA PRAKASH BABU,Independent,33,1,34,0.02,Tirupati,167,Andhra Pradesh 
2469,SURYA NARAYANA SYDAM,Independent,28,1,29,0.01,Tirupati,167,Andhra Pradesh 
2470,GURRALA BALAKRISHNA,Independent,72,0,72,0.04,Tirupati,167,Andhra Pradesh 
2471,NOTA,None of the Above,1218,63,1281,0.66,Tirupati,167,Andhra Pradesh 
2472,KUNTRAPAKU SURENDRA BABU,Bahujan Samaj Party,1397,6,1403,0.67,Srikalahasti,168,Andhra Pradesh 
2473,DR. POTHUGUNTA RAJESH NAIDU,Indian National Congress,2971,31,3002,1.43,Srikalahasti,168,Andhra Pradesh 
2474,BIYYAPU MADHUSUDHAN REDDY,Yuvajana Sramika Rythu Congress Party,77575,686,78261,37.39,Srikalahasti,168,Andhra Pradesh 
2475,BOJJALA VENKATA SUDHIR REDDY,Telugu Desam,119554,2011,121565,58.08,Srikalahasti,168,Andhra Pradesh 
2476,KUPPANNAGARI DINAD BABU,Bharatha Chaitanya Yuvajana Party,545,2,547,0.26,Srikalahasti,168,Andhra Pradesh 
2477,DR.GANUGAPENTA RAMESH,Nationalist Janshakti Party,112,1,113,0.05,Srikalahasti,168,Andhra Pradesh 
2478,D.GOVINDASWAMY,Samajwadi Party,90,1,91,0.04,Srikalahasti,168,Andhra Pradesh 
2479,NIRANJAN REDDY ROMMALA,Jai Bharat National Party,144,2,146,0.07,Srikalahasti,168,Andhra Pradesh 
2480,PAVANI ATTIRALA,Pyramid Party of India,134,1,135,0.06,Srikalahasti,168,Andhra Pradesh 
2481,PULI PUSHPALATHA,Viduthalai Chiruthaigal Katchi,124,3,127,0.06,Srikalahasti,168,Andhra Pradesh 
2482,YELLAIAH CHUKKALA,Independent,100,1,101,0.05,Srikalahasti,168,Andhra Pradesh 
2483,K.CHIRANJEEVI,Independent,261,3,264,0.13,Srikalahasti,168,Andhra Pradesh 
2484,P.SRINIVASULU REDDY,Independent,334,1,335,0.16,Srikalahasti,168,Andhra Pradesh 
2485,PERAM NAGARAJU NAIDU,Independent,228,0,228,0.11,Srikalahasti,168,Andhra Pradesh 
2486,THIGALA BHASKAR,Independent,1018,5,1023,0.49,Srikalahasti,168,Andhra Pradesh 
2487,NOTA,None of the Above,1949,26,1975,0.94,Srikalahasti,168,Andhra Pradesh 
2488,KONETI ADIMULAM,Telugu Desam,84626,845,85471,46.32,Satyavedu,169,Andhra Pradesh 
2489,NUKATHOTI RAJESH,Yuvajana Sramika Rythu Congress Party,81311,421,81732,44.29,Satyavedu,169,Andhra Pradesh 
2490,BALAGURAVAM BABU,Indian National Congress,5424,20,5444,2.95,Satyavedu,169,Andhra Pradesh 
2491,C. SUPRIYA,Bahujan Samaj Party,924,10,934,0.51,Satyavedu,169,Andhra Pradesh 
2492,V. KIRAN,Jai Bharat National Party,220,0,220,0.12,Satyavedu,169,Andhra Pradesh 
2493,VIJAY KUMAR G.SRKR,Liberation Congress Party,385,7,392,0.21,Satyavedu,169,Andhra Pradesh 
2494,C KIRAN KUMAR,Independent,108,0,108,0.06,Satyavedu,169,Andhra Pradesh 
2495,KOGILA VENKATACHALAM,Independent,138,0,138,0.07,Satyavedu,169,Andhra Pradesh 
2496,KOLLA VIJAYA KUMAR,Independent,183,1,184,0.1,Satyavedu,169,Andhra Pradesh 
2497,N. CHENGAIAH,Independent,139,1,140,0.08,Satyavedu,169,Andhra Pradesh 
2498,YATHATI RAMESH BABU,Independent,3456,30,3486,1.89,Satyavedu,169,Andhra Pradesh 
2499,KOMMALA RAGHAVAIAH,Independent,158,0,158,0.09,Satyavedu,169,Andhra Pradesh 
2500,JADDA RAJA SEKHAR,Independent,2627,24,2651,1.44,Satyavedu,169,Andhra Pradesh 
2501,VETTI VENKATESH,Independent,265,0,265,0.14,Satyavedu,169,Andhra Pradesh 
2502,VEMPALLA KRISHNA RAO,Independent,433,2,435,0.24,Satyavedu,169,Andhra Pradesh 
2503,NOTA,None of the Above,2753,11,2764,1.5,Satyavedu,169,Andhra Pradesh 
2504,GALI BHANU PRAKASH,Telugu Desam,106094,1703,107797,60.38,Nagari,170,Andhra Pradesh 
2505,P. RAKESH REDDY,Indian National Congress,4516,35,4551,2.55,Nagari,170,Andhra Pradesh 
2506,R.K. ROJA,Yuvajana Sramika Rythu Congress Party,62229,564,62793,35.17,Nagari,170,Andhra Pradesh 
2507,GNANA PRAKASH,Navarang Congress Party,348,3,351,0.2,Nagari,170,Andhra Pradesh 
2508,P. JAYARAMAIAH,Independent,815,4,819,0.46,Nagari,170,Andhra Pradesh 
2509,BATHALA DHILLI BABU,Independent,155,2,157,0.09,Nagari,170,Andhra Pradesh 
2510,K. ROJA,Independent,316,2,318,0.18,Nagari,170,Andhra Pradesh 
2511,NOTA,None of the Above,1729,15,1744,0.98,Nagari,170,Andhra Pradesh 
2512,K. KRUPALAKSHMI,Yuvajana Sramika Rythu Congress Party,74586,579,75165,41.02,Gangadhara Nellore (SC),171,Andhra Pradesh 
2513,DR. VM. THOMAS,Telugu Desam,99455,1721,101176,55.22,Gangadhara Nellore (SC),171,Andhra Pradesh 
2514,BHASKAR PODHUTOOR,Bahujan Samaj Party,773,6,779,0.43,Gangadhara Nellore (SC),171,Andhra Pradesh 
2515,RAMESH BABU. D,Indian National Congress,2659,23,2682,1.46,Gangadhara Nellore (SC),171,Andhra Pradesh 
2516,P. GUNASEKHAR,Samajwadi Party,282,0,282,0.15,Gangadhara Nellore (SC),171,Andhra Pradesh 
2517,V. RAMA RAJU,Akhil Bharatiya Jan Sangh,164,0,164,0.09,Gangadhara Nellore (SC),171,Andhra Pradesh 
2518,USURUPATI PADMANABHAM,Independent,185,1,186,0.1,Gangadhara Nellore (SC),171,Andhra Pradesh 
2519,K. KARUNA SREE,Independent,151,2,153,0.08,Gangadhara Nellore (SC),171,Andhra Pradesh 
2520,DEVARAJ,Independent,139,2,141,0.08,Gangadhara Nellore (SC),171,Andhra Pradesh 
2521,PULIVELAM MADHU,Independent,126,1,127,0.07,Gangadhara Nellore (SC),171,Andhra Pradesh 
2522,K. RAMU,Independent,241,0,241,0.13,Gangadhara Nellore (SC),171,Andhra Pradesh 
2523,NOTA,None of the Above,2113,12,2125,1.16,Gangadhara Nellore (SC),171,Andhra Pradesh 
2524,GURAJALA JAGAN MOHAN (GJM),Telugu Desam,85734,2332,88066,52.49,Chittoor,172,Andhra Pradesh 
2525,M.C. VIJAYANANDA REDDY,Yuvajana Sramika Rythu Congress Party,72399,1063,73462,43.78,Chittoor,172,Andhra Pradesh 
2526,G.TIKARAM @ TIKKI ROYAL,Indian National Congress,3197,67,3264,1.95,Chittoor,172,Andhra Pradesh 
2527,B. LOKANADHAM,Bahujan Samaj Party,613,8,621,0.37,Chittoor,172,Andhra Pradesh 
2528,DR. B.K. RAMANA REDDY,Akhil Bharatiya Jan Sangh,218,3,221,0.13,Chittoor,172,Andhra Pradesh 
2529,V. RAVI,Jaibhim Rao Bharat Party,83,2,85,0.05,Chittoor,172,Andhra Pradesh 
2530,V. SARITHA,Samajwadi Party,48,2,50,0.03,Chittoor,172,Andhra Pradesh 
2531,ANVESH MULAGURU,Independent,59,3,62,0.04,Chittoor,172,Andhra Pradesh 
2532,KOVI MOHAN VIJAYA KUMAR,Independent,63,1,64,0.04,Chittoor,172,Andhra Pradesh 
2533,V. THEJESH,Independent,209,3,212,0.13,Chittoor,172,Andhra Pradesh 
2534,V. PURUSHOTAM,Independent,115,5,120,0.07,Chittoor,172,Andhra Pradesh 
2535,K.PRABHAKAR REDDY,Independent,62,0,62,0.04,Chittoor,172,Andhra Pradesh 
2536,I. RIYAZ BASHA @ DADI MUNNA,Independent,399,5,404,0.24,Chittoor,172,Andhra Pradesh 
2537,NOTA,None of the Above,1061,35,1096,0.65,Chittoor,172,Andhra Pradesh 
2538,KANIPAKAM NAGESWARA,Bahujan Samaj Party,740,15,755,0.39,Puthalapattu (SC) ,173,Andhra Pradesh 
2539,M BABU,Indian National Congress,2769,51,2820,1.45,Puthalapattu (SC) ,173,Andhra Pradesh 
2540,K MURALI MOHAN,Telugu Desam,100592,1545,102137,52.37,Puthalapattu (SC) ,173,Andhra Pradesh 
2541,M SUNEEL KUMAR,Yuvajana Sramika Rythu Congress Party,85644,859,86503,44.36,Puthalapattu (SC) ,173,Andhra Pradesh 
2542,KATTAMANCHI VISWANADH SAI MOHAN,Akhil Bharatiya Jan Sangh,339,1,340,0.17,Puthalapattu (SC) ,173,Andhra Pradesh 
2543,TOTI N R NAVEEN,All India Mahila Empowerment Party,275,1,276,0.14,Puthalapattu (SC) ,173,Andhra Pradesh 
2544,AMMURU PURUSHOTHAM,Samajwadi Party,77,0,77,0.04,Puthalapattu (SC) ,173,Andhra Pradesh 
2545,K SANTHOSH,Viduthalai Chiruthaigal Katchi,128,2,130,0.07,Puthalapattu (SC) ,173,Andhra Pradesh 
2546,N HARIPRASAD,Bharatha Chaitanya Yuvajana Party,143,0,143,0.07,Puthalapattu (SC) ,173,Andhra Pradesh 
2547,C PRAVEEN KUMAR,Independent,128,2,130,0.07,Puthalapattu (SC) ,173,Andhra Pradesh 
2548,M V VIJAYA BHASKAR,Independent,138,1,139,0.07,Puthalapattu (SC) ,173,Andhra Pradesh 
2549,R RAJA,Independent,148,0,148,0.08,Puthalapattu (SC) ,173,Andhra Pradesh 
2550,NOTA,None of the Above,1405,15,1420,0.73,Puthalapattu (SC) ,173,Andhra Pradesh 
2551,AMARANATHA REDDY. N,Telugu Desam,121698,1534,123232,52.09,Palamaner,174,Andhra Pradesh 
2552,VENKATE GOWDA. N,Yuvajana Sramika Rythu Congress Party,102596,514,103110,43.59,Palamaner,174,Andhra Pradesh 
2553,B. SIVASANKAR,Indian National Congress,3992,23,4015,1.7,Palamaner,174,Andhra Pradesh 
2554,R. SHOBHA,Bahujan Samaj Party,694,5,699,0.3,Palamaner,174,Andhra Pradesh 
2555,C. VINOD KUMAR,Viduthalai Chiruthaigal Katchi,247,4,251,0.11,Palamaner,174,Andhra Pradesh 
2556,AMARANATHA REDDY,Independent,127,0,127,0.05,Palamaner,174,Andhra Pradesh 
2557,AMARANADHA REDDY. R,Independent,174,0,174,0.07,Palamaner,174,Andhra Pradesh 
2558,ARUN KUMAR. S,Independent,654,2,656,0.28,Palamaner,174,Andhra Pradesh 
2559,ALASAPURA SUBRAMANYAMU,Independent,188,0,188,0.08,Palamaner,174,Andhra Pradesh 
2560,C. UMAMAHESWAR REDDY,Independent,156,0,156,0.07,Palamaner,174,Andhra Pradesh 
2561,L. DAMODARA NAIDU,Independent,167,0,167,0.07,Palamaner,174,Andhra Pradesh 
2562,V. PAVITHRA KAVALI,Independent,193,0,193,0.08,Palamaner,174,Andhra Pradesh 
2563,K. BASHA,Independent,159,0,159,0.07,Palamaner,174,Andhra Pradesh 
2564,BOMMANAPALLI LAKSHMANNA,Independent,1081,4,1085,0.46,Palamaner,174,Andhra Pradesh 
2565,NOTA,None of the Above,2324,20,2344,0.99,Palamaner,174,Andhra Pradesh 
2566,C. GANESH,Bahujan Samaj Party,558,1,559,0.27,Kuppam,175,Andhra Pradesh 
2567,A. GOVINDHARAJULU,Indian National Congress,2562,12,2574,1.27,Kuppam,175,Andhra Pradesh 
2568,CHANDRABABU NAIDU NARA,Telugu Desam,120926,1003,121929,59.96,Kuppam,175,Andhra Pradesh 
2569,K.R.J. BHARATH,Yuvajana Sramika Rythu Congress Party,73586,337,73923,36.35,Kuppam,175,Andhra Pradesh 
2570,AKBAR,Bharatiya Prajagala Kalyana Paksha,322,0,322,0.16,Kuppam,175,Andhra Pradesh 
2571,GOVINDAPPA,Viduthalai Chiruthaigal Katchi,212,0,212,0.1,Kuppam,175,Andhra Pradesh 
2572,D. PRASAD,Pyramid Party of India,166,0,166,0.08,Kuppam,175,Andhra Pradesh 
2573,T. THIMMARAYAPPA,Independent,224,0,224,0.11,Kuppam,175,Andhra Pradesh 
2574,N. NAGARAJU,Independent,128,0,128,0.06,Kuppam,175,Andhra Pradesh 
2575,NEELA JAGADEESH,Independent,567,9,576,0.28,Kuppam,175,Andhra Pradesh 
2576,K. PRAKASH,Independent,152,1,153,0.08,Kuppam,175,Andhra Pradesh 
2577,B. MURALIDHAR @ VASANADU MURALI,Independent,198,0,198,0.1,Kuppam,175,Andhra Pradesh 
2578,SURENDRA KUMAR,Independent,288,0,288,0.14,Kuppam,175,Andhra Pradesh 
2579,NOTA,None of the Above,2111,4,2115,1.04,Kuppam,175,Andhra Pradesh 
